GGTCTGTTATATGGTGTACCCAAACTCGTG|TTTGGTTAATAAGTTCACAATGACATGTTC
GCCCCGCGGGTGTGCTCTAGGTTCGACACG|CAGTCTATCTCCGACCCTGGTGTACCCAAA
CGGGGCTAGAGTTGGGTCATTGGTGTACCC|CCCCTAACATACGAATCCATAACCCTAAGG
CCGCGGGTGTGCTCTAGGTTCGACACGCTC|TCTATCTCCGACCCTGGTGTACCCAAACTC
AACAAGTTGGGGTGTCGAATAGCTATTCTG|TGGTGGTTGGTGTACCCAAACTCGTGGTCG
CCAGAGAGCCCTGTCGTAAGGGGGACGGGG|TAGGTCTAAACGAGACACAGACGGTAGTTT
CGTGGTCGACGCCGTACGAAGCAGGTCGAG|TTAACATAGGTACATCGGGCTCACTGAAGG
AAACTCGTGGTCGACGCCGTTGGTGTACCC|GTCGACGCCGTCTGAGGTTAGAATCTAGAA
GACGCCGTAGGGGCTAACTAAATGGTGTAC|ATCTCAGATTCAGAAAGATACAATGGTGTA
AAGCTTCTCCACTGGTGTACCCAAACTCGT|GATCTGAAGTCTACTGGATATAACCATGGT
CGACGCCGTTGGTGTACCCAAACTCGTGGT|CTGAGGTTAGAATCTAGAATCATTTAATTG
TCGACGCCGTCTGAGGTTAGAATCTAGAAT|ACGCTCGCGTCACCTAGGGTTCGGTGAACC
TTCAGAATCTCTCTACCTGGTGTACCCAAA|CTGTTGTACGGTGTCTCCAAGACGGTCTCA
TGGTGGTTGGTGTACCCAAACTCGTGGTCG|TCAAAAACTCTCCATTACCGAGACCGTCGT
CTCGCTCAAAAACTCTCCATTACCGAGACC|CCCAAACTCGTGGTCGACGCCGTTGGTGTA
CCAAACTCGTGGTCGACGCCGTTGGTGTAC|TGGTCGACGCCGTCTGAGGTTAGAATCTAG
AGACGGTAGTTTGCCTCTATCTACTATCGC|CTGTTATATGGTGTACCCAAACTCGTGGTC
CGGTAGTTTGCCTCTATCTACTATCGCGAG|TTATATGGTGTACCCAAACTCGTGGTCGAC
GCTAGGTCTAAACGAGACACAGACGGTAGT|TCCCTTTATGGGTAAACGGTCTGTTATATG
AAAAACTCTCCATTACCGAGACCGTCGTAT|TCGTGGTCGACGCCGTTGGTGTACCCAAAC
AGCCGAAAGCTTCTCCACTGGTGTACCCAA|CTGTACGATCTGAAGTCTACTGGATATAAC
CCTAGGTACGGCTCTGCCGTAACAAGTTGG|TAGGTCTCGGGCTTGCCGTTTGGTGGTTGG
AAATGGTGTACCCAAACTCGTGGTCGACGC|ACAATGGTGTACCCAAACTCGTGGTCGACG
GTCGACGCCGTCTACAGAACAAGAGCAGCC|TATGGTAGTTTCGCAATATTCTTCTGTCCA
CGTCGCATCAAGAGGACCTAGGTACGGCTC|CTCGTGGTCGACGCCGTAGGTCTCGGGCTT
GCTCTCGGGCTGTACGATCTGAAGTCTACT|CCCAAACTCGTGGTCGACGCCGTTGTACCC
TCTGAGGTTAGAATCTAGAATCATTTAATT|TCACCTAGGGTTCGGTGAACCAGAGAGCCC
AAACTCGTGGTCGACGCCGTACGAAGCAGG|ACTTCTTAACATAGGTACATCGGGCTCACT
GTTAATAAGTTCACAATGACATGTTCAGAA|GTGGTCGACGCCGTTCAACTTGACTGTTGT
CTCGTGGTCGACGCCGTAGGTCTCGGGCTT|AGCAGGTCGAGTCAACTGTTTCAGTTGTAC
GCCGTGGCTGAAAGGTTTGATGAGGTAAGC|TCTCTACCTGGTGTACCCAAACTCGTGGTC
GGTCGACGCCGTAATCCTGCTAGGTCTAAA|GGTCGACGCCGTAGCTGGTCCCTTTATGGG
AAGCAGGTCGAGTCAACTGTTTCAGTTGTA|GCTCACTGAAGGCCGGCTCTCCATATGGTG
TGGTCGACGCCGTAGGGGCTAACTAAATGG|ATTGGATCTCAGATTCAGAAAGATACAATG
CTACCTGGTGTACCCAAACTCGTGGTCGAC|GTCTCCAAGACGGTCTCATGAACATATGGT
TACCCAAACTCGTGGTCGACGCCGTAATCC|TACCCAAACTCGTGGTCGACGCCGTAGCTG
TTAATAAGTTCACAATGACATGTTCAGAAT|TGGTCGACGCCGTTCAACTTGACTGTTGTA
ACACTCGCTCAAAAACTCTCCATTACCGAG|GTACCCAAACTCGTGGTCGACGCCGTTGGT
GCCGTCGCATCAAGAGGACCTAGGTACGGC|AACTCGTGGTCGACGCCGTAGGTCTCGGGC
CGTGGTCGACGCCGTCTGAGGTTAGAATCT|TCGACACGCTCGCGTCACCTAGGGTTCGGT
TGCTAGGTCTAAACGAGACACAGACGGTAG|GTCCCTTTATGGGTAAACGGTCTGTTATAT
GTTTGATGAGGTAAGCGTTTCCTCCTATGA|ACCCAAACTCGTGGTCGACGCCGTCTACAG
CTCGGGCTTGCCGTTTGGTGGTTGGTGTAC|CAGTTGTACACTCGCTCAAAAACTCTCCAT
TAGGTACGGCTCTGCCGTAACAAGTTGGGG|GGTCTCGGGCTTGCCGTTTGGTGGTTGGTG
ACCTAGGTACGGCTCTGCCGTAACAAGTTG|GTAGGTCTCGGGCTTGCCGTTTGGTGGTTG
TTCTATGCCGATTCGCCGCGTCGCCCTAAT|TGAAAGGTTTGATGAGGTAAGCGTTTCCTC
CCGAGACCGTCGTATCAGGCTACGGACCCC|TTGGTGTACCCAAACTCGTGGTCGACGCCG
CTCGTGGTCGACGCCGTGTAACACCAGTTG|ACTCGTGGTCGACGCCGTAGACAACATGCC
ATGGTGTACCCAAACTCGTGGTCGACGCCG|CCAAACTCGTGGTCGACGCCGTCTGAGGTT
TCAGATTCAGAAAGATACAATGGTGTACCC|TAAGGGGGACGGGGCGGACAATCTGCGGAT
GTGTACCCAAACTCGTGGTCGACGCCGTTC|CCCTAAGGGCCTAGAGACAATGTCATACAT
GGTGTGCTCTAGGTTCGACACGCTCGCGTC|CTCCGACCCTGGTGTACCCAAACTCGTGGT
CTGCGGATCTTCTTCAGACCTGGCAGTGAA|CTACTATCGCGAGTCGTCGCTTTCTATGCC
AATCCTGCTAGGTCTAAACGAGACACAGAC|AGCTGGTCCCTTTATGGGTAAACGGTCTGT
CGTGGTCGACGCCGTCGCATCAAGAGGACC|GGTGTACCCAAACTCGTGGTCGACGCCGTA
ACTCGTGGTCGACGCCGTACGAAGCAGGTC|TTCTTAACATAGGTACATCGGGCTCACTGA
TAGAATCATTTAATTGGATCTCAGATTCAG|TGAACCAGAGAGCCCTGTCGTAAGGGGGAC
CGTCACCTAGGGTTCGGTGAACCAGAGAGC|TGGTCGACGCCGTAATCCTGCTAGGTCTAA
CGAATAGCTATTCTGAGCAAGGTAAGCTCT|CCAAACTCGTGGTCGACGCCGTGTACCCAA
CATTTAATTGGATCTCAGATTCAGAAAGAT|AGAGAGCCCTGTCGTAAGGGGGACGGGGCG
TCGCGTCACCTAGGGTTCGGTGAACCAGAG|TCGTGGTCGACGCCGTAATCCTGCTAGGTC
TAGGGTTCGGTGAACCAGAGAGCCCTGTCG|CGCCGTAATCCTGCTAGGTCTAAACGAGAC
ATGGGTAAACGGTCTGTTATATGGTGTACC|TGACTATCGATTTGGTTAATAAGTTCACAA
CGTCGTATCAGGCTACGGACCCCTGTTGTG|ACCCAAACTCGTGGTCGACGCCGTAGGGGC
GTCGACGCCGTAGCTGGTCCCTTTATGGGT|CCACTTGGGCGGGAATTAGCAGTTTGACTA
CATATGGTGTACCCAAACTCGTGGTCGACG|TACCCAAACTCGTGGTCGACGCCGTCTGAG
AGAACAAGAGCAGCCCTAACCGGGGCTAGA|ATATTCTTCTGTCCAAGGTCCCCCTAACAT
GTACATCGGGCTCACTGAAGGCCGGCTCTC|GACGCCGTGTAACACCAGTTGTGTATGGTG
GGGCTAACTAAATGGTGTACCCAAACTCGT|CAGAAAGATACAATGGTGTACCCAAACTCG
CTATCGATTTGGTTAATAAGTTCACAATGA|TACCCAAACTCGTGGTCGACGCCGTTCAAC
GATTTGGTTAATAAGTTCACAATGACATGT|AAACTCGTGGTCGACGCCGTTCAACTTGAC
CCAAACTCGTGGTCGACGCCGTACGAAGCA|AGACTTCTTAACATAGGTACATCGGGCTCA
TCATTGGTGTACCCAAACTCGTGGTCGACG|CCATAACCCTAAGGGCCTAGAGACAATGTC
CCGCGTCGCCCTAATTGCTGGTGTACCCAA|GGTAAGCGTTTCCTCCTATGAGGTTATCTC
GCGTCACCTAGGGTTCGGTGAACCAGAGAG|GTGGTCGACGCCGTAATCCTGCTAGGTCTA
TACACTCGCTCAAAAACTCTCCATTACCGA|TGTACCCAAACTCGTGGTCGACGCCGTTGG
TTAATTGGATCTCAGATTCAGAAAGATACA|GAGCCCTGTCGTAAGGGGGACGGGGCGGAC
GGTAAGCTCTCGGGCTGTACGATCTGAAGT|GTGTACCCAAACTCGTGGTCGACGCCGTTG
TTACAACAGTCTATCTCCGACCCTGGTGTA|ATTCGCCGCGTCGCCCTAATTGCTGGTGTA
GCTCACTGAAGGCCGGCTCTCCATATGGTG|TAACACCAGTTGTGTATGGTGTACCCAAAC
GACGCCGTCGCATCAAGAGGACCTAGGTAC|CCAAACTCGTGGTCGACGCCGTAGGTCTCG
AGTCAACTGTTTCAGTTGTACACTCGCTCA|GGCCGGCTCTCCATATGGTGTACCCAAACT
CTGCCGTAACAAGTTGGGGTGTCGAATAGC|TGCCGTTTGGTGGTTGGTGTACCCAAACTC
GTCGACGCCGTGTAACACCAGTTGTGTATG|GGTCGACGCCGTAGACAACATGCCCCGCGG
CCATATGGTGTACCCAAACTCGTGGTCGAC|GTACCCAAACTCGTGGTCGACGCCGTCTGA
GGCTGTACGATCTGAAGTCTACTGGATATA|TCGTGGTCGACGCCGTTGTACCCAAACTCG
GGATCTCAGATTCAGAAAGATACAATGGTG|TGTCGTAAGGGGGACGGGGCGGACAATCTG
TGTACCCAAACTCGTGGTCGACGCCGTCTG|TGTGCTCTAGGTTCGACACGCTCGCGTCAC
TGAGGTAAGCGTTTCCTCCTATGAGGTTAT|ACTCGTGGTCGACGCCGTCTACAGAACAAG
ACAGAACAAGAGCAGCCCTAACCGGGGCTA|CAATATTCTTCTGTCCAAGGTCCCCCTAAC
GGAATTAGCAGTTTGACTATCGATTTGGTT|AGTTGGGTCATTGGTGTACCCAAACTCGTG
GTCGACGCCGTGTACCCAAACTCGTGGTCG|TCGTATCAGGCTACGGACCCCTGTTGTGGA
GGTCGACGCCGTAGCTGGTCCCTTTATGGG|ACCACTTGGGCGGGAATTAGCAGTTTGACT
GGATGGGAAGCTACTAGACTTCTTAACATA|CTAACTAAATGGTGTACCCAAACTCGTGGT
AGCTATTCTGAGCAAGGTAAGCTCTCGGGC|CTCGTGGTCGACGCCGTGTACCCAAACTCG
CAAACTCGTGGTCGACGCCGTCTGAGGTTA|CTAGGTTCGACACGCTCGCGTCACCTAGGG
CAGGTCGAGTCAACTGTTTCAGTTGTACAC|CACTGAAGGCCGGCTCTCCATATGGTGTAC
ACCCAAACTCGTGGTCGACGCCGTTGGTGT|CGTGGTCGACGCCGTCTGAGGTTAGAATCT
CGTGGTCGACGCCGTTGGTGTACCCAAACT|CGCCGTCTGAGGTTAGAATCTAGAATCATT
TGGTGTACCCAAACTCGTGGTCGACGCCGT|ATCTGCGGATCTTCTTCAGACCTGGCAGTG
GACCCCTGTTGTGGATGGGAAGCTACTAGA|ACGCCGTAGGGGCTAACTAAATGGTGTACC
ACCCAAACTCGTGGTCGACGCCGTAGGGGC|AGAATCATTTAATTGGATCTCAGATTCAGA
TCCTGCTAGGTCTAAACGAGACACAGACGG|CTGGTCCCTTTATGGGTAAACGGTCTGTTA
CCGTGGCTGAAAGGTTTGATGAGGTAAGCG|CTCTACCTGGTGTACCCAAACTCGTGGTCG
GTGGTTGGTGTACCCAAACTCGTGGTCGAC|AAAAACTCTCCATTACCGAGACCGTCGTAT
TTTATGGGTAAACGGTCTGTTATATGGTGT|GTTTGACTATCGATTTGGTTAATAAGTTCA
AGAGTTGGGTCATTGGTGTACCCAAACTCG|CATACGAATCCATAACCCTAAGGGCCTAGA
GCTAGAGTTGGGTCATTGGTGTACCCAAAC|TAACATACGAATCCATAACCCTAAGGGCCT
GTACCCAAACTCGTGGTCGACGCCGTGGCT|CACAATGACATGTTCAGAATCTCTCTACCT
AACTCGTGGTCGACGCCGTAGACAACATGC|TTCTTCAGACCTGGCAGTGAAGTTACAACA
TATGGGTAAACGGTCTGTTATATGGTGTAC|TTGACTATCGATTTGGTTAATAAGTTCACA
GTACCCAAACTCGTGGTCGACGCCGTCTAC|ACGGTCTCATGAACATATGGTAGTTTCGCA
GAGCCCTGTCGTAAGGGGGACGGGGCGGAC|CTAAACGAGACACAGACGGTAGTTTGCCTC
ACTAGACTTCTTAACATAGGTACATCGGGC|TGTACCCAAACTCGTGGTCGACGCCGTGTA
TTATATGGTGTACCCAAACTCGTGGTCGAC|TAATAAGTTCACAATGACATGTTCAGAATC
CTAGACTTCTTAACATAGGTACATCGGGCT|GTACCCAAACTCGTGGTCGACGCCGTGTAA
CCGTTTGGTGGTTGGTGTACCCAAACTCGT|CTCGCTCAAAAACTCTCCATTACCGAGACC
TGGTGTACCCAAACTCGTGGTCGACGCCGT|CTCTCCATTACCGAGACCGTCGTATCAGGC
GTACCCAAACTCGTGGTCGACGCCGTAGAC|GCGGATCTTCTTCAGACCTGGCAGTGAAGT
ACTCGCTCAAAAACTCTCCATTACCGAGAC|ACCCAAACTCGTGGTCGACGCCGTTGGTGT
CTATCGCGAGTCGTCGCTTTCTATGCCGAT|CGTGGTCGACGCCGTGGCTGAAAGGTTTGA
CGCCGTAGGGGCTAACTAAATGGTGTACCC|CTCAGATTCAGAAAGATACAATGGTGTACC
CATGCCCCGCGGGTGTGCTCTAGGTTCGAC|CAACAGTCTATCTCCGACCCTGGTGTACCC
GATCTTCTTCAGACCTGGCAGTGAAGTTAC|ATCGCGAGTCGTCGCTTTCTATGCCGATTC
CGACGCCGTAGGTCTCGGGCTTGCCGTTTG|GAGTCAACTGTTTCAGTTGTACACTCGCTC
TCTATCTACTATCGCGAGTCGTCGCTTTCT|CCCAAACTCGTGGTCGACGCCGTGGCTGAA
TTCAGTTGTACACTCGCTCAAAAACTCTCC|CCATATGGTGTACCCAAACTCGTGGTCGAC
AAACTCGTGGTCGACGCCGTTGTACCCAAA|CCCCTGTTGTGGATGGGAAGCTACTAGACT
GTGTACCCAAACTCGTGGTCGACGCCGTCT|AGACGGTCTCATGAACATATGGTAGTTTCG
CTCGTGGTCGACGCCGTGGCTGAAAGGTTT|ATGTTCAGAATCTCTCTACCTGGTGTACCC
AATTGCTGGTGTACCCAAACTCGTGGTCGA|CTCCTATGAGGTTATCTCCAACTCACCACT
TCACTGAAGGCCGGCTCTCCATATGGTGTA|ACACCAGTTGTGTATGGTGTACCCAAACTC
GTCGTCGCTTTCTATGCCGATTCGCCGCGT|CGCCGTGGCTGAAAGGTTTGATGAGGTAAG
AACTCGTGGTCGACGCCGTAGGTCTCGGGC|GAAGCAGGTCGAGTCAACTGTTTCAGTTGT
TATCAGGCTACGGACCCCTGTTGTGGATGG|AACTCGTGGTCGACGCCGTAGGGGCTAACT
AGTTACAACAGTCTATCTCCGACCCTGGTG|CGATTCGCCGCGTCGCCCTAATTGCTGGTG
GTCGCCCTAATTGCTGGTGTACCCAAACTC|AGCGTTTCCTCCTATGAGGTTATCTCCAAC
ACGGTAGTTTGCCTCTATCTACTATCGCGA|GTTATATGGTGTACCCAAACTCGTGGTCGA
AGCGTTTCCTCCTATGAGGTTATCTCCAAC|GTCGACGCCGTCTACAGAACAAGAGCAGCC
CAGAGAGCCCTGTCGTAAGGGGGACGGGGC|AGGTCTAAACGAGACACAGACGGTAGTTTG
CGTGGTCGACGCCGTAGGGGCTAACTAAAT|TAATTGGATCTCAGATTCAGAAAGATACAA
AACACCAGTTGTGTATGGTGTACCCAAACT|GACAACATGCCCCGCGGGTGTGCTCTAGGT
CTTTCTATGCCGATTCGCCGCGTCGCCCTA|GCTGAAAGGTTTGATGAGGTAAGCGTTTCC
TGGATATAACCATGGTGTACCCAAACTCGT|CAAACTCGTGGTCGACGCCGTACGAAGCAG
GGTCGACGCCGTAGACAACATGCCCCGCGG|GACCTGGCAGTGAAGTTACAACAGTCTATC
CGAGTCAACTGTTTCAGTTGTACACTCGCT|AAGGCCGGCTCTCCATATGGTGTACCCAAA
GGTCGACGCCGTGTACCCAAACTCGTGGTC|GTCGTATCAGGCTACGGACCCCTGTTGTGG
ACCCAAACTCGTGGTCGACGCCGTAGGTCT|CGTACGAAGCAGGTCGAGTCAACTGTTTCA
CCGTCGCATCAAGAGGACCTAGGTACGGCT|ACTCGTGGTCGACGCCGTAGGTCTCGGGCT
TGCTCTAGGTTCGACACGCTCGCGTCACCT|GACCCTGGTGTACCCAAACTCGTGGTCGAC
ACAATGACATGTTCAGAATCTCTCTACCTG|GTTCAACTTGACTGTTGTACGGTGTCTCCA
TGGTCGACGCCGTCTGAGGTTAGAATCTAG|GACACGCTCGCGTCACCTAGGGTTCGGTGA
ACCCAAACTCGTGGTCGACGCCGTAATCCT|ACCCAAACTCGTGGTCGACGCCGTAGCTGG
CGCCGTCTACAGAACAAGAGCAGCCCTAAC|TAGTTTCGCAATATTCTTCTGTCCAAGGTC
CATGTTCAGAATCTCTCTACCTGGTGTACC|TTGACTGTTGTACGGTGTCTCCAAGACGGT
TGGGGTGTCGAATAGCTATTCTGAGCAAGG|TGGTGTACCCAAACTCGTGGTCGACGCCGT
ACCTGGTGTACCCAAACTCGTGGTCGACGC|CTCCAAGACGGTCTCATGAACATATGGTAG
GTAGCTGGTCCCTTTATGGGTAAACGGTCT|CGGGAATTAGCAGTTTGACTATCGATTTGG
GGGCTTGCCGTTTGGTGGTTGGTGTACCCA|TTGTACACTCGCTCAAAAACTCTCCATTAC
GTGGTCGACGCCGTACGAAGCAGGTCGAGT|TAACATAGGTACATCGGGCTCACTGAAGGC
GTTTGCCTCTATCTACTATCGCGAGTCGTC|TGGTGTACCCAAACTCGTGGTCGACGCCGT
CGATTTGGTTAATAAGTTCACAATGACATG|CAAACTCGTGGTCGACGCCGTTCAACTTGA
GGTTAATAAGTTCACAATGACATGTTCAGA|CGTGGTCGACGCCGTTCAACTTGACTGTTG
AGCTTCTCCACTGGTGTACCCAAACTCGTG|ATCTGAAGTCTACTGGATATAACCATGGTG
TTTCAGTTGTACACTCGCTCAAAAACTCTC|TCCATATGGTGTACCCAAACTCGTGGTCGA
TAACACCAGTTGTGTATGGTGTACCCAAAC|AGACAACATGCCCCGCGGGTGTGCTCTAGG
ACGGGGCGGACAATCTGCGGATCTTCTTCA|TAGTTTGCCTCTATCTACTATCGCGAGTCG
TCAGAATCTCTCTACCTGGTGTACCCAAAC|TGTTGTACGGTGTCTCCAAGACGGTCTCAT
GACAATCTGCGGATCTTCTTCAGACCTGGC|CTCTATCTACTATCGCGAGTCGTCGCTTTC
CCCTGTTGTGGATGGGAAGCTACTAGACTT|CCGTAGGGGCTAACTAAATGGTGTACCCAA
TAAACGGTCTGTTATATGGTGTACCCAAAC|ATCGATTTGGTTAATAAGTTCACAATGACA
AGAATCTAGAATCATTTAATTGGATCTCAG|GTTCGGTGAACCAGAGAGCCCTGTCGTAAG
AACGGTCTGTTATATGGTGTACCCAAACTC|CGATTTGGTTAATAAGTTCACAATGACATG
TGGTCCCTTTATGGGTAAACGGTCTGTTAT|ATTAGCAGTTTGACTATCGATTTGGTTAAT
GTTGGGGTGTCGAATAGCTATTCTGAGCAA|GTTGGTGTACCCAAACTCGTGGTCGACGCC
TCGTGGTCGACGCCGTACGAAGCAGGTCGA|CTTAACATAGGTACATCGGGCTCACTGAAG
GGGTGTGCTCTAGGTTCGACACGCTCGCGT|TCTCCGACCCTGGTGTACCCAAACTCGTGG
GGGACGGGGCGGACAATCTGCGGATCTTCT|CGGTAGTTTGCCTCTATCTACTATCGCGAG
GTCGCTTTCTATGCCGATTCGCCGCGTCGC|CGTGGCTGAAAGGTTTGATGAGGTAAGCGT
GCGAGTCGTCGCTTTCTATGCCGATTCGCC|TCGACGCCGTGGCTGAAAGGTTTGATGAGG
CAAACTCGTGGTCGACGCCGTGGCTGAAAG|TGACATGTTCAGAATCTCTCTACCTGGTGT
CCAAACTCGTGGTCGACGCCGTCGCATCAA|TAACCATGGTGTACCCAAACTCGTGGTCGA
GTAACACCAGTTGTGTATGGTGTACCCAAA|TAGACAACATGCCCCGCGGGTGTGCTCTAG
TCTCTACCTGGTGTACCCAAACTCGTGGTC|GGTGTCTCCAAGACGGTCTCATGAACATAT
GCTCTGCCGTAACAAGTTGGGGTGTCGAAT|GCTTGCCGTTTGGTGGTTGGTGTACCCAAA
GTCGACGCCGTCGCATCAAGAGGACCTAGG|TACCCAAACTCGTGGTCGACGCCGTAGGTC
AAACTCGTGGTCGACGCCGTGTAACACCAG|CAAACTCGTGGTCGACGCCGTAGACAACAT
GTGGTCGACGCCGTCTGAGGTTAGAATCTA|CGACACGCTCGCGTCACCTAGGGTTCGGTG
GTGGTCGACGCCGTAGACAACATGCCCCGC|CAGACCTGGCAGTGAAGTTACAACAGTCTA
GATACAATGGTGTACCCAAACTCGTGGTCG|GCGGACAATCTGCGGATCTTCTTCAGACCT
CTACTATCGCGAGTCGTCGCTTTCTATGCC|ACTCGTGGTCGACGCCGTGGCTGAAAGGTT
AGCTACTAGACTTCTTAACATAGGTACATC|ATGGTGTACCCAAACTCGTGGTCGACGCCG
AGTTGTACACTCGCTCAAAAACTCTCCATT|TATGGTGTACCCAAACTCGTGGTCGACGCC
GGGGTGTCGAATAGCTATTCTGAGCAAGGT|GGTGTACCCAAACTCGTGGTCGACGCCGTG
TGTACCCAAACTCGTGGTCGACGCCGTAAT|TGTACCCAAACTCGTGGTCGACGCCGTAGC
CCGGGGCTAGAGTTGGGTCATTGGTGTACC|CCCCCTAACATACGAATCCATAACCCTAAG
GCTTGCCGTTTGGTGGTTGGTGTACCCAAA|GTACACTCGCTCAAAAACTCTCCATTACCG
TGTACCCAAACTCGTGGTCGACGCCGTTGT|CTACGGACCCCTGTTGTGGATGGGAAGCTA
CATGGTGTACCCAAACTCGTGGTCGACGCC|GTCGACGCCGTACGAAGCAGGTCGAGTCAA
GCCTCTATCTACTATCGCGAGTCGTCGCTT|GTACCCAAACTCGTGGTCGACGCCGTGGCT
TGTAACACCAGTTGTGTATGGTGTACCCAA|GTAGACAACATGCCCCGCGGGTGTGCTCTA
AGAATCTCTCTACCTGGTGTACCCAAACTC|TTGTACGGTGTCTCCAAGACGGTCTCATGA
GCCGTTTGGTGGTTGGTGTACCCAAACTCG|ACTCGCTCAAAAACTCTCCATTACCGAGAC
TTCAGAAAGATACAATGGTGTACCCAAACT|GGGACGGGGCGGACAATCTGCGGATCTTCT
CCAGTTGTGTATGGTGTACCCAAACTCGTG|ACATGCCCCGCGGGTGTGCTCTAGGTTCGA
CAACTGTTTCAGTTGTACACTCGCTCAAAA|CGGCTCTCCATATGGTGTACCCAAACTCGT
GGTCGACGCCGTTGTACCCAAACTCGTGGT|GTGGATGGGAAGCTACTAGACTTCTTAACA
ATCAAGAGGACCTAGGTACGGCTCTGCCGT|GTCGACGCCGTAGGTCTCGGGCTTGCCGTT
TCTAAACGAGACACAGACGGTAGTTTGCCT|TATGGGTAAACGGTCTGTTATATGGTGTAC
CTCCATATGGTGTACCCAAACTCGTGGTCG|GTGTACCCAAACTCGTGGTCGACGCCGTCT
AATCTAGAATCATTTAATTGGATCTCAGAT|TCGGTGAACCAGAGAGCCCTGTCGTAAGGG
ATGCCGATTCGCCGCGTCGCCCTAATTGCT|AGGTTTGATGAGGTAAGCGTTTCCTCCTAT
CCCAAACTCGTGGTCGACGCCGTGTAACAC|ACCCAAACTCGTGGTCGACGCCGTAGACAA
ATAGCTATTCTGAGCAAGGTAAGCTCTCGG|AACTCGTGGTCGACGCCGTGTACCCAAACT
ACGCCGTAGGTCTCGGGCTTGCCGTTTGGT|GTCAACTGTTTCAGTTGTACACTCGCTCAA
CTACTGGATATAACCATGGTGTACCCAAAC|TACCCAAACTCGTGGTCGACGCCGTACGAA
CTGTTTCAGTTGTACACTCGCTCAAAAACT|CTCTCCATATGGTGTACCCAAACTCGTGGT
CAAACTCGTGGTCGACGCCGTCTACAGAAC|CTCATGAACATATGGTAGTTTCGCAATATT
TATCTACTATCGCGAGTCGTCGCTTTCTAT|CAAACTCGTGGTCGACGCCGTGGCTGAAAG
TCGACGCCGTCTACAGAACAAGAGCAGCCC|ATGGTAGTTTCGCAATATTCTTCTGTCCAA
CCCAAACTCGTGGTCGACGCCGTAGACAAC|GATCTTCTTCAGACCTGGCAGTGAAGTTAC
GTCGACGCCGTGGCTGAAAGGTTTGATGAG|AGAATCTCTCTACCTGGTGTACCCAAACTC
CCTTTATGGGTAAACGGTCTGTTATATGGT|CAGTTTGACTATCGATTTGGTTAATAAGTT
CGACGCCGTAATCCTGCTAGGTCTAAACGA|CGACGCCGTAGCTGGTCCCTTTATGGGTAA
ATGGTGTACCCAAACTCGTGGTCGACGCCG|TCGACGCCGTACGAAGCAGGTCGAGTCAAC
ACCCTGGTGTACCCAAACTCGTGGTCGACG|TTGCTGGTGTACCCAAACTCGTGGTCGACG
TCGACGCCGTGTAACACCAGTTGTGTATGG|GTCGACGCCGTAGACAACATGCCCCGCGGG
AAGCTACTAGACTTCTTAACATAGGTACAT|AATGGTGTACCCAAACTCGTGGTCGACGCC
GTCGACGCCGTAGGGGCTAACTAAATGGTG|TGGATCTCAGATTCAGAAAGATACAATGGT
AGTCGTCGCTTTCTATGCCGATTCGCCGCG|ACGCCGTGGCTGAAAGGTTTGATGAGGTAA
GCCGTACGAAGCAGGTCGAGTCAACTGTTT|TACATCGGGCTCACTGAAGGCCGGCTCTCC
CCCAAACTCGTGGTCGACGCCGTCTACAGA|GTCTCATGAACATATGGTAGTTTCGCAATA
CCTGTCGTAAGGGGGACGGGGCGGACAATC|ACGAGACACAGACGGTAGTTTGCCTCTATC
GAAAGATACAATGGTGTACCCAAACTCGTG|CGGGGCGGACAATCTGCGGATCTTCTTCAG
GTCTACAGAACAAGAGCAGCCCTAACCGGG|TTCGCAATATTCTTCTGTCCAAGGTCCCCC
CGGATCTTCTTCAGACCTGGCAGTGAAGTT|CTATCGCGAGTCGTCGCTTTCTATGCCGAT
AACTCACCACTTGGGCGGGAATTAGCAGTT|GCCCTAACCGGGGCTAGAGTTGGGTCATTG
GAATCATTTAATTGGATCTCAGATTCAGAA|AACCAGAGAGCCCTGTCGTAAGGGGGACGG
CGACGCCGTCTACAGAACAAGAGCAGCCCT|TGGTAGTTTCGCAATATTCTTCTGTCCAAG
ACCCAAACTCGTGGTCGACGCCGTGTACCC|ATTACCGAGACCGTCGTATCAGGCTACGGA
TTGTACACTCGCTCAAAAACTCTCCATTAC|TGGTGTACCCAAACTCGTGGTCGACGCCGT
CCGTGTACCCAAACTCGTGGTCGACGCCGT|AGGCTACGGACCCCTGTTGTGGATGGGAAG
CTGGCAGTGAAGTTACAACAGTCTATCTCC|CTTTCTATGCCGATTCGCCGCGTCGCCCTA
TCGTGGTCGACGCCGTCTACAGAACAAGAG|GAACATATGGTAGTTTCGCAATATTCTTCT
CCGTAGACAACATGCCCCGCGGGTGTGCTC|AGTGAAGTTACAACAGTCTATCTCCGACCC
GTGGTCGACGCCGTTGGTGTACCCAAACTC|GCCGTCTGAGGTTAGAATCTAGAATCATTT
TTTGACTATCGATTTGGTTAATAAGTTCAC|TGGTGTACCCAAACTCGTGGTCGACGCCGT
AAGTTGGGGTGTCGAATAGCTATTCTGAGC|TGGTTGGTGTACCCAAACTCGTGGTCGACG
ACGGACCCCTGTTGTGGATGGGAAGCTACT|TCGACGCCGTAGGGGCTAACTAAATGGTGT
AACTCGTGGTCGACGCCGTCTACAGAACAA|CATGAACATATGGTAGTTTCGCAATATTCT
ACTATCGCGAGTCGTCGCTTTCTATGCCGA|TCGTGGTCGACGCCGTGGCTGAAAGGTTTG
TGGTCGACGCCGTCGCATCAAGAGGACCTA|TGTACCCAAACTCGTGGTCGACGCCGTAGG
TCTACTGGATATAACCATGGTGTACCCAAA|GTACCCAAACTCGTGGTCGACGCCGTACGA
ATGAGCCGAAAGCTTCTCCACTGGTGTACC|GGGCTGTACGATCTGAAGTCTACTGGATAT
ACGGCTCTGCCGTAACAAGTTGGGGTGTCG|CGGGCTTGCCGTTTGGTGGTTGGTGTACCC
CTAGGGTTCGGTGAACCAGAGAGCCCTGTC|ACGCCGTAATCCTGCTAGGTCTAAACGAGA
CCGTACGAAGCAGGTCGAGTCAACTGTTTC|ACATCGGGCTCACTGAAGGCCGGCTCTCCA
CAAACTCGTGGTCGACGCCGTAGGTCTCGG|ACGAAGCAGGTCGAGTCAACTGTTTCAGTT
TACCCAAACTCGTGGTCGACGCCGTTGTAC|ACGGACCCCTGTTGTGGATGGGAAGCTACT
TAGGTACATCGGGCTCACTGAAGGCCGGCT|GTCGACGCCGTGTAACACCAGTTGTGTATG
TGTTTCAGTTGTACACTCGCTCAAAAACTC|TCTCCATATGGTGTACCCAAACTCGTGGTC
CTCACCACTTGGGCGGGAATTAGCAGTTTG|CCTAACCGGGGCTAGAGTTGGGTCATTGGT
ATCTCCAACTCACCACTTGGGCGGGAATTA|AGAGCAGCCCTAACCGGGGCTAGAGTTGGG
TCTCTCTACCTGGTGTACCCAAACTCGTGG|ACGGTGTCTCCAAGACGGTCTCATGAACAT
TCCAACTCACCACTTGGGCGGGAATTAGCA|GCAGCCCTAACCGGGGCTAGAGTTGGGTCA
TACGATCTGAAGTCTACTGGATATAACCAT|GTCGACGCCGTTGTACCCAAACTCGTGGTC
GTGGTCGACGCCGTAATCCTGCTAGGTCTA|GTGGTCGACGCCGTAGCTGGTCCCTTTATG
CCGTCGTATCAGGCTACGGACCCCTGTTGT|TACCCAAACTCGTGGTCGACGCCGTAGGGG
GGCTACGGACCCCTGTTGTGGATGGGAAGC|GTGGTCGACGCCGTAGGGGCTAACTAAATG
TTGGTGTACCCAAACTCGTGGTCGACGCCG|ACTCTCCATTACCGAGACCGTCGTATCAGG
CGACGCCGTCTGAGGTTAGAATCTAGAATC|CGCTCGCGTCACCTAGGGTTCGGTGAACCA
TAAGCTCTCGGGCTGTACGATCTGAAGTCT|GTACCCAAACTCGTGGTCGACGCCGTTGTA
GTTCAGAATCTCTCTACCTGGTGTACCCAA|ACTGTTGTACGGTGTCTCCAAGACGGTCTC
ACTGGTGTACCCAAACTCGTGGTCGACGCC|CTACTGGATATAACCATGGTGTACCCAAAC
ACCCAAACTCGTGGTCGACGCCGTCTACAG|GGTCTCATGAACATATGGTAGTTTCGCAAT
ACTCGTGGTCGACGCCGTTGGTGTACCCAA|CGACGCCGTCTGAGGTTAGAATCTAGAATC
CGAGTCGTCGCTTTCTATGCCGATTCGCCG|CGACGCCGTGGCTGAAAGGTTTGATGAGGT
CCATTACCGAGACCGTCGTATCAGGCTACG|ACGCCGTTGGTGTACCCAAACTCGTGGTCG
TACAACAGTCTATCTCCGACCCTGGTGTAC|TTCGCCGCGTCGCCCTAATTGCTGGTGTAC
CGCCGTAGGTCTCGGGCTTGCCGTTTGGTG|TCAACTGTTTCAGTTGTACACTCGCTCAAA
TCGACGCCGTCGCATCAAGAGGACCTAGGT|ACCCAAACTCGTGGTCGACGCCGTAGGTCT
GTACCCAAACTCGTGGTCGACGCCGTTCAA|CTAAGGGCCTAGAGACAATGTCATACATCA
AGTTGGGGTGTCGAATAGCTATTCTGAGCA|GGTTGGTGTACCCAAACTCGTGGTCGACGC
TGGGTCATTGGTGTACCCAAACTCGTGGTC|GAATCCATAACCCTAAGGGCCTAGAGACAA
CAAACTCGTGGTCGACGCCGTAGGGGCTAA|ATCATTTAATTGGATCTCAGATTCAGAAAG
GGTCATTGGTGTACCCAAACTCGTGGTCGA|ATCCATAACCCTAAGGGCCTAGAGACAATG
TACCCAAACTCGTGGTCGACGCCGTAGCTG|TTATCTCCAACTCACCACTTGGGCGGGAAT
TCAGGCTACGGACCCCTGTTGTGGATGGGA|CTCGTGGTCGACGCCGTAGGGGCTAACTAA
CCCAAACTCGTGGTCGACGCCGTAGGTCTC|GTACGAAGCAGGTCGAGTCAACTGTTTCAG
GGTTTGATGAGGTAAGCGTTTCCTCCTATG|TACCCAAACTCGTGGTCGACGCCGTCTACA
CTGAAGTCTACTGGATATAACCATGGTGTA|GCCGTTGTACCCAAACTCGTGGTCGACGCC
GTACCCAAACTCGTGGTCGACGCCGTAATC|GTACCCAAACTCGTGGTCGACGCCGTAGCT
GGATCTTCTTCAGACCTGGCAGTGAAGTTA|TATCGCGAGTCGTCGCTTTCTATGCCGATT
ATCTACTATCGCGAGTCGTCGCTTTCTATG|AAACTCGTGGTCGACGCCGTGGCTGAAAGG
TACGGACCCCTGTTGTGGATGGGAAGCTAC|GTCGACGCCGTAGGGGCTAACTAAATGGTG
CCAAACTCGTGGTCGACGCCGTAATCCTGC|CCAAACTCGTGGTCGACGCCGTAGCTGGTC
GGGGCTAGAGTTGGGTCATTGGTGTACCCA|CCCTAACATACGAATCCATAACCCTAAGGG
GGTGTACCCAAACTCGTGGTCGACGCCGTT|AAACTCGTGGTCGACGCCGTCTGAGGTTAG
GGCGGACAATCTGCGGATCTTCTTCAGACC|TTGCCTCTATCTACTATCGCGAGTCGTCGC
AACTCGTGGTCGACGCCGTTGTACCCAAAC|CCCTGTTGTGGATGGGAAGCTACTAGACTT
GACGCCGTAGCTGGTCCCTTTATGGGTAAA|CTTGGGCGGGAATTAGCAGTTTGACTATCG
AGGTACATCGGGCTCACTGAAGGCCGGCTC|TCGACGCCGTGTAACACCAGTTGTGTATGG
CAAGAGGACCTAGGTACGGCTCTGCCGTAA|CGACGCCGTAGGTCTCGGGCTTGCCGTTTG
CTCTCCATATGGTGTACCCAAACTCGTGGT|TGGTGTACCCAAACTCGTGGTCGACGCCGT
CGTCTGAGGTTAGAATCTAGAATCATTTAA|CGTCACCTAGGGTTCGGTGAACCAGAGAGC
TCTACAGAACAAGAGCAGCCCTAACCGGGG|TCGCAATATTCTTCTGTCCAAGGTCCCCCT
ACGCCGTGTAACACCAGTTGTGTATGGTGT|GACGCCGTAGACAACATGCCCCGCGGGTGT
GTACCCAAACTCGTGGTCGACGCCGTTGTA|TACGGACCCCTGTTGTGGATGGGAAGCTAC
CTATCTACTATCGCGAGTCGTCGCTTTCTA|CCAAACTCGTGGTCGACGCCGTGGCTGAAA
GTTTGACTATCGATTTGGTTAATAAGTTCA|TTGGTGTACCCAAACTCGTGGTCGACGCCG
GATTCAGAAAGATACAATGGTGTACCCAAA|GGGGGACGGGGCGGACAATCTGCGGATCTT
AAACTCTCCATTACCGAGACCGTCGTATCA|GTGGTCGACGCCGTTGGTGTACCCAAACTC
TGACTATCGATTTGGTTAATAAGTTCACAA|GTGTACCCAAACTCGTGGTCGACGCCGTTC
GGTGTACCCAAACTCGTGGTCGACGCCGTA|GAGGTTATCTCCAACTCACCACTTGGGCGG
CTCTACCTGGTGTACCCAAACTCGTGGTCG|GTGTCTCCAAGACGGTCTCATGAACATATG
GTTCACAATGACATGTTCAGAATCTCTCTA|CGCCGTTCAACTTGACTGTTGTACGGTGTC
AAAGATACAATGGTGTACCCAAACTCGTGG|GGGGCGGACAATCTGCGGATCTTCTTCAGA
TTGGTGTACCCAAACTCGTGGTCGACGCCG|TAACCCTAAGGGCCTAGAGACAATGTCATA
ACTCGTGGTCGACGCCGTGTAACACCAGTT|AACTCGTGGTCGACGCCGTAGACAACATGC
AGACCGTCGTATCAGGCTACGGACCCCTGT|GTGTACCCAAACTCGTGGTCGACGCCGTAG
CGCTCGCGTCACCTAGGGTTCGGTGAACCA|AACTCGTGGTCGACGCCGTAATCCTGCTAG
CAGCCCTAACCGGGGCTAGAGTTGGGTCAT|GTCCAAGGTCCCCCTAACATACGAATCCAT
TGAGGTTAGAATCTAGAATCATTTAATTGG|ACCTAGGGTTCGGTGAACCAGAGAGCCCTG
AAACTCGTGGTCGACGCCGTAGGTCTCGGG|CGAAGCAGGTCGAGTCAACTGTTTCAGTTG
GCGTTTCCTCCTATGAGGTTATCTCCAACT|TCGACGCCGTCTACAGAACAAGAGCAGCCC
ATTACCGAGACCGTCGTATCAGGCTACGGA|GCCGTTGGTGTACCCAAACTCGTGGTCGAC
TCACCACTTGGGCGGGAATTAGCAGTTTGA|CTAACCGGGGCTAGAGTTGGGTCATTGGTG
GCCGTTGTACCCAAACTCGTGGTCGACGCC|GGAAGCTACTAGACTTCTTAACATAGGTAC
CCCAAACTCGTGGTCGACGCCGTACGAAGC|TAGACTTCTTAACATAGGTACATCGGGCTC
CACAATGACATGTTCAGAATCTCTCTACCT|CGTTCAACTTGACTGTTGTACGGTGTCTCC
GTGTATGGTGTACCCAAACTCGTGGTCGAC|CCCGCGGGTGTGCTCTAGGTTCGACACGCT
TACCCAAACTCGTGGTCGACGCCGTTCAAC|TAAGGGCCTAGAGACAATGTCATACATCAG
GAGACCGTCGTATCAGGCTACGGACCCCTG|GGTGTACCCAAACTCGTGGTCGACGCCGTA
CGCCCTAATTGCTGGTGTACCCAAACTCGT|CGTTTCCTCCTATGAGGTTATCTCCAACTC
AGGTAAGCTCTCGGGCTGTACGATCTGAAG|CGTGTACCCAAACTCGTGGTCGACGCCGTT
AAGGCCGGCTCTCCATATGGTGTACCCAAA|GTTGTGTATGGTGTACCCAAACTCGTGGTC
TGGTCGACGCCGTAGCTGGTCCCTTTATGG|CACCACTTGGGCGGGAATTAGCAGTTTGAC
CGGGCTGTACGATCTGAAGTCTACTGGATA|ACTCGTGGTCGACGCCGTTGTACCCAAACT
TGTACCCAAACTCGTGGTCGACGCCGTAGG|TCTAGAATCATTTAATTGGATCTCAGATTC
AAACGAGACACAGACGGTAGTTTGCCTCTA|GGGTAAACGGTCTGTTATATGGTGTACCCA
TGGTGTACCCAAACTCGTGGTCGACGCCGT|GAATCTAGAATCATTTAATTGGATCTCAGA
GAAGGCCGGCTCTCCATATGGTGTACCCAA|AGTTGTGTATGGTGTACCCAAACTCGTGGT
TCGCCGCGTCGCCCTAATTGCTGGTGTACC|TGAGGTAAGCGTTTCCTCCTATGAGGTTAT
ACTCGTGGTCGACGCCGTAGGTCTCGGGCT|AAGCAGGTCGAGTCAACTGTTTCAGTTGTA
TCGACGCCGTAGACAACATGCCCCGCGGGT|CCTGGCAGTGAAGTTACAACAGTCTATCTC
GTTGTACCCAAACTCGTGGTCGACGCCGTA|AGCTACTAGACTTCTTAACATAGGTACATC
GTACCCAAACTCGTGGTCGACGCCGTCGCA|GATATAACCATGGTGTACCCAAACTCGTGG
ACTCGTGGTCGACGCCGTAGCTGGTCCCTT|CAACTCACCACTTGGGCGGGAATTAGCAGT
ACAGACGGTAGTTTGCCTCTATCTACTATC|GTCTGTTATATGGTGTACCCAAACTCGTGG
CGCGGGTGTGCTCTAGGTTCGACACGCTCG|CTATCTCCGACCCTGGTGTACCCAAACTCG
CCAAACTCGTGGTCGACGCCGTCTGAGGTT|TCTAGGTTCGACACGCTCGCGTCACCTAGG
GCCGCGTCGCCCTAATTGCTGGTGTACCCA|AGGTAAGCGTTTCCTCCTATGAGGTTATCT
ATTCTGAGCAAGGTAAGCTCTCGGGCTGTA|TGGTCGACGCCGTGTACCCAAACTCGTGGT
ATCCTGCTAGGTCTAAACGAGACACAGACG|GCTGGTCCCTTTATGGGTAAACGGTCTGTT
CGGACCCCTGTTGTGGATGGGAAGCTACTA|CGACGCCGTAGGGGCTAACTAAATGGTGTA
CTCCAACTCACCACTTGGGCGGGAATTAGC|AGCAGCCCTAACCGGGGCTAGAGTTGGGTC
ACAATCTGCGGATCTTCTTCAGACCTGGCA|TCTATCTACTATCGCGAGTCGTCGCTTTCT
GTCGACGCCGTAGGTCTCGGGCTTGCCGTT|TCGAGTCAACTGTTTCAGTTGTACACTCGC
AGGTTTGATGAGGTAAGCGTTTCCTCCTAT|GTACCCAAACTCGTGGTCGACGCCGTCTAC
CTATGAGGTTATCTCCAACTCACCACTTGG|CTACAGAACAAGAGCAGCCCTAACCGGGGC
CGTCGCCCTAATTGCTGGTGTACCCAAACT|AAGCGTTTCCTCCTATGAGGTTATCTCCAA
CTCCACTGGTGTACCCAAACTCGTGGTCGA|AAGTCTACTGGATATAACCATGGTGTACCC
TGGTGTACCCAAACTCGTGGTCGACGCCGT|AACCCTAAGGGCCTAGAGACAATGTCATAC
AACTCGTGGTCGACGCCGTAGCTGGTCCCT|CCAACTCACCACTTGGGCGGGAATTAGCAG
CGTCTACAGAACAAGAGCAGCCCTAACCGG|TTTCGCAATATTCTTCTGTCCAAGGTCCCC
GTGTGCTCTAGGTTCGACACGCTCGCGTCA|TCCGACCCTGGTGTACCCAAACTCGTGGTC
TATGGTGTACCCAAACTCGTGGTCGACGCC|CCCAAACTCGTGGTCGACGCCGTCTGAGGT
CCGTGTAACACCAGTTGTGTATGGTGTACC|GCCGTAGACAACATGCCCCGCGGGTGTGCT
CAGGCTACGGACCCCTGTTGTGGATGGGAA|TCGTGGTCGACGCCGTAGGGGCTAACTAAA
TCGAGTCAACTGTTTCAGTTGTACACTCGC|GAAGGCCGGCTCTCCATATGGTGTACCCAA
AGGTTATCTCCAACTCACCACTTGGGCGGG|GAACAAGAGCAGCCCTAACCGGGGCTAGAG
GAAGTCTACTGGATATAACCATGGTGTACC|CGTTGTACCCAAACTCGTGGTCGACGCCGT
CTACAGAACAAGAGCAGCCCTAACCGGGGC|CGCAATATTCTTCTGTCCAAGGTCCCCCTA
TGGGTAAACGGTCTGTTATATGGTGTACCC|GACTATCGATTTGGTTAATAAGTTCACAAT
TCTGAAGTCTACTGGATATAACCATGGTGT|CGCCGTTGTACCCAAACTCGTGGTCGACGC
GTGTACCCAAACTCGTGGTCGACGCCGTGG|TTCACAATGACATGTTCAGAATCTCTCTAC
CTGCTAGGTCTAAACGAGACACAGACGGTA|GGTCCCTTTATGGGTAAACGGTCTGTTATA
TGTACCCAAACTCGTGGTCGACGCCGTACG|CTACTAGACTTCTTAACATAGGTACATCGG
GGTCGACGCCGTCTACAGAACAAGAGCAGC|ATATGGTAGTTTCGCAATATTCTTCTGTCC
CTATGCCGATTCGCCGCGTCGCCCTAATTG|AAAGGTTTGATGAGGTAAGCGTTTCCTCCT
CCCCGCGGGTGTGCTCTAGGTTCGACACGC|AGTCTATCTCCGACCCTGGTGTACCCAAAC
ATTTGGTTAATAAGTTCACAATGACATGTT|AACTCGTGGTCGACGCCGTTCAACTTGACT
TTTGGTTAATAAGTTCACAATGACATGTTC|ACTCGTGGTCGACGCCGTTCAACTTGACTG
TTATCTCCAACTCACCACTTGGGCGGGAAT|CAAGAGCAGCCCTAACCGGGGCTAGAGTTG
TCCACTGGTGTACCCAAACTCGTGGTCGAC|AGTCTACTGGATATAACCATGGTGTACCCA
CCAAACTCGTGGTCGACGCCGTAGGTCTCG|TACGAAGCAGGTCGAGTCAACTGTTTCAGT
GACTATCGATTTGGTTAATAAGTTCACAAT|TGTACCCAAACTCGTGGTCGACGCCGTTCA
GACACAGACGGTAGTTTGCCTCTATCTACT|ACGGTCTGTTATATGGTGTACCCAAACTCG
CGTAGGGGCTAACTAAATGGTGTACCCAAA|AGATTCAGAAAGATACAATGGTGTACCCAA
CCTGCTAGGTCTAAACGAGACACAGACGGT|TGGTCCCTTTATGGGTAAACGGTCTGTTAT
ACTCGTGGTCGACGCCGTAGGGGCTAACTA|ATTTAATTGGATCTCAGATTCAGAAAGATA
ACCGAGACCGTCGTATCAGGCTACGGACCC|GTTGGTGTACCCAAACTCGTGGTCGACGCC
GTCGACGCCGTACGAAGCAGGTCGAGTCAA|CATAGGTACATCGGGCTCACTGAAGGCCGG
AACATGCCCCGCGGGTGTGCTCTAGGTTCG|TACAACAGTCTATCTCCGACCCTGGTGTAC
GTGAACCAGAGAGCCCTGTCGTAAGGGGGA|CCTGCTAGGTCTAAACGAGACACAGACGGT
CCGGCTCTCCATATGGTGTACCCAAACTCG|TGTATGGTGTACCCAAACTCGTGGTCGACG
TAAGGGGGACGGGGCGGACAATCTGCGGAT|ACAGACGGTAGTTTGCCTCTATCTACTATC
TAGCAGTTTGACTATCGATTTGGTTAATAA|GGTCATTGGTGTACCCAAACTCGTGGTCGA
CTCGTGGTCGACGCCGTAGGGGCTAACTAA|TTTAATTGGATCTCAGATTCAGAAAGATAC
GGGTGTCGAATAGCTATTCTGAGCAAGGTA|GTGTACCCAAACTCGTGGTCGACGCCGTGT
CCCCTGTTGTGGATGGGAAGCTACTAGACT|GCCGTAGGGGCTAACTAAATGGTGTACCCA
TGGATGGGAAGCTACTAGACTTCTTAACAT|GCTAACTAAATGGTGTACCCAAACTCGTGG
TGTACCCAAACTCGTGGTCGACGCCGTCTA|GACGGTCTCATGAACATATGGTAGTTTCGC
TCTTCAGACCTGGCAGTGAAGTTACAACAG|GAGTCGTCGCTTTCTATGCCGATTCGCCGC
ACTCGTGGTCGACGCCGTGGCTGAAAGGTT|CATGTTCAGAATCTCTCTACCTGGTGTACC
TAACCGGGGCTAGAGTTGGGTCATTGGTGT|GGTCCCCCTAACATACGAATCCATAACCCT
CAAACTCGTGGTCGACGCCGTACGAAGCAG|GACTTCTTAACATAGGTACATCGGGCTCAC
AAGGGGGACGGGGCGGACAATCTGCGGATC|CAGACGGTAGTTTGCCTCTATCTACTATCG
TTCTTAACATAGGTACATCGGGCTCACTGA|AAACTCGTGGTCGACGCCGTGTAACACCAG
GCCGTAGGGGCTAACTAAATGGTGTACCCA|TCAGATTCAGAAAGATACAATGGTGTACCC
CTCCATTACCGAGACCGTCGTATCAGGCTA|CGACGCCGTTGGTGTACCCAAACTCGTGGT
CGTGGTCGACGCCGTGGCTGAAAGGTTTGA|GTTCAGAATCTCTCTACCTGGTGTACCCAA
ATCTCAGATTCAGAAAGATACAATGGTGTA|TCGTAAGGGGGACGGGGCGGACAATCTGCG
CAAACTCGTGGTCGACGCCGTGTACCCAAA|ACCGAGACCGTCGTATCAGGCTACGGACCC
ACCCAAACTCGTGGTCGACGCCGTACGAAG|CTAGACTTCTTAACATAGGTACATCGGGCT
GTGAAGTTACAACAGTCTATCTCCGACCCT|ATGCCGATTCGCCGCGTCGCCCTAATTGCT
TCGACGCCGTACGAAGCAGGTCGAGTCAAC|ATAGGTACATCGGGCTCACTGAAGGCCGGC
CAAAAACTCTCCATTACCGAGACCGTCGTA|CTCGTGGTCGACGCCGTTGGTGTACCCAAA
GGTGTACCCAAACTCGTGGTCGACGCCGTC|GGTGTGCTCTAGGTTCGACACGCTCGCGTC
GATCTGAAGTCTACTGGATATAACCATGGT|GACGCCGTTGTACCCAAACTCGTGGTCGAC
GTGGTCGACGCCGTAGCTGGTCCCTTTATG|TCACCACTTGGGCGGGAATTAGCAGTTTGA
CCGTAGGGGCTAACTAAATGGTGTACCCAA|CAGATTCAGAAAGATACAATGGTGTACCCA
CGCGAGTCGTCGCTTTCTATGCCGATTCGC|GTCGACGCCGTGGCTGAAAGGTTTGATGAG
CTCGGGCTGTACGATCTGAAGTCTACTGGA|AAACTCGTGGTCGACGCCGTTGTACCCAAA
ACTGAAGGCCGGCTCTCCATATGGTGTACC|ACCAGTTGTGTATGGTGTACCCAAACTCGT
TAACATAGGTACATCGGGCTCACTGAAGGC|TCGTGGTCGACGCCGTGTAACACCAGTTGT
AGACTTCTTAACATAGGTACATCGGGCTCA|ACCCAAACTCGTGGTCGACGCCGTGTAACA
CCGTAATCCTGCTAGGTCTAAACGAGACAC|CCGTAGCTGGTCCCTTTATGGGTAAACGGT
GAGGACCTAGGTACGGCTCTGCCGTAACAA|CGCCGTAGGTCTCGGGCTTGCCGTTTGGTG
CCACTTGGGCGGGAATTAGCAGTTTGACTA|ACCGGGGCTAGAGTTGGGTCATTGGTGTAC
TCGTATCAGGCTACGGACCCCTGTTGTGGA|CCAAACTCGTGGTCGACGCCGTAGGGGCTA
CGGTCTGTTATATGGTGTACCCAAACTCGT|ATTTGGTTAATAAGTTCACAATGACATGTT
GGTAAGCGTTTCCTCCTATGAGGTTATCTC|CGTGGTCGACGCCGTCTACAGAACAAGAGC
CAACTCACCACTTGGGCGGGAATTAGCAGT|AGCCCTAACCGGGGCTAGAGTTGGGTCATT
AATTAGCAGTTTGACTATCGATTTGGTTAA|TTGGGTCATTGGTGTACCCAAACTCGTGGT
GGCTCTGCCGTAACAAGTTGGGGTGTCGAA|GGCTTGCCGTTTGGTGGTTGGTGTACCCAA
GTACGGCTCTGCCGTAACAAGTTGGGGTGT|CTCGGGCTTGCCGTTTGGTGGTTGGTGTAC
ATCTAGAATCATTTAATTGGATCTCAGATT|CGGTGAACCAGAGAGCCCTGTCGTAAGGGG
GGTGTCGAATAGCTATTCTGAGCAAGGTAA|TGTACCCAAACTCGTGGTCGACGCCGTGTA
ACGCCGTAATCCTGCTAGGTCTAAACGAGA|ACGCCGTAGCTGGTCCCTTTATGGGTAAAC
TTGGTGTACCCAAACTCGTGGTCGACGCCG|AGAATCTAGAATCATTTAATTGGATCTCAG
GTGGTCGACGCCGTGTAACACCAGTTGTGT|CGTGGTCGACGCCGTAGACAACATGCCCCG
GGGGGACGGGGCGGACAATCTGCGGATCTT|GACGGTAGTTTGCCTCTATCTACTATCGCG
CCGTTGGTGTACCCAAACTCGTGGTCGACG|GTTAGAATCTAGAATCATTTAATTGGATCT
TCTCCGACCCTGGTGTACCCAAACTCGTGG|CCCTAATTGCTGGTGTACCCAAACTCGTGG
TCACAATGACATGTTCAGAATCTCTCTACC|CCGTTCAACTTGACTGTTGTACGGTGTCTC
GGGCTGTACGATCTGAAGTCTACTGGATAT|CTCGTGGTCGACGCCGTTGTACCCAAACTC
CAATCTGCGGATCTTCTTCAGACCTGGCAG|CTATCTACTATCGCGAGTCGTCGCTTTCTA
CAAGTTGGGGTGTCGAATAGCTATTCTGAG|GTGGTTGGTGTACCCAAACTCGTGGTCGAC
GTGTACCCAAACTCGTGGTCGACGCCGTCT|GTGTGCTCTAGGTTCGACACGCTCGCGTCA
CGCCGTAATCCTGCTAGGTCTAAACGAGAC|CGCCGTAGCTGGTCCCTTTATGGGTAAACG
GTATCAGGCTACGGACCCCTGTTGTGGATG|AAACTCGTGGTCGACGCCGTAGGGGCTAAC
CATAGGTACATCGGGCTCACTGAAGGCCGG|TGGTCGACGCCGTGTAACACCAGTTGTGTA
TCGTGGTCGACGCCGTTGGTGTACCCAAAC|ACGCCGTCTGAGGTTAGAATCTAGAATCAT
GGTCGACGCCGTAGGGGCTAACTAAATGGT|TTGGATCTCAGATTCAGAAAGATACAATGG
TTCCTCCTATGAGGTTATCTCCAACTCACC|CGCCGTCTACAGAACAAGAGCAGCCCTAAC
ACGCCGTTGTACCCAAACTCGTGGTCGACG|TGGGAAGCTACTAGACTTCTTAACATAGGT
CGCCGTAGCTGGTCCCTTTATGGGTAAACG|TGGGCGGGAATTAGCAGTTTGACTATCGAT
ACCACTTGGGCGGGAATTAGCAGTTTGACT|AACCGGGGCTAGAGTTGGGTCATTGGTGTA
TATCGCGAGTCGTCGCTTTCTATGCCGATT|GTGGTCGACGCCGTGGCTGAAAGGTTTGAT
CAGTGAAGTTACAACAGTCTATCTCCGACC|CTATGCCGATTCGCCGCGTCGCCCTAATTG
ACCAGAGAGCCCTGTCGTAAGGGGGACGGG|CTAGGTCTAAACGAGACACAGACGGTAGTT
TACTATCGCGAGTCGTCGCTTTCTATGCCG|CTCGTGGTCGACGCCGTGGCTGAAAGGTTT
TCTCCACTGGTGTACCCAAACTCGTGGTCG|GAAGTCTACTGGATATAACCATGGTGTACC
ACATAGGTACATCGGGCTCACTGAAGGCCG|GTGGTCGACGCCGTGTAACACCAGTTGTGT
GTACACTCGCTCAAAAACTCTCCATTACCG|GTGTACCCAAACTCGTGGTCGACGCCGTTG
CTAGGTCTAAACGAGACACAGACGGTAGTT|CCCTTTATGGGTAAACGGTCTGTTATATGG
GTAAGGGGGACGGGGCGGACAATCTGCGGA|CACAGACGGTAGTTTGCCTCTATCTACTAT
AAGTTCACAATGACATGTTCAGAATCTCTC|GACGCCGTTCAACTTGACTGTTGTACGGTG
CAGTTGTGTATGGTGTACCCAAACTCGTGG|CATGCCCCGCGGGTGTGCTCTAGGTTCGAC
TTGGTGGTTGGTGTACCCAAACTCGTGGTC|CTCAAAAACTCTCCATTACCGAGACCGTCG
TCGACACGCTCGCGTCACCTAGGGTTCGGT|TACCCAAACTCGTGGTCGACGCCGTAATCC
AACCATGGTGTACCCAAACTCGTGGTCGAC|GTGGTCGACGCCGTACGAAGCAGGTCGAGT
GACGCCGTGGCTGAAAGGTTTGATGAGGTA|ATCTCTCTACCTGGTGTACCCAAACTCGTG
AACTCGTGGTCGACGCCGTACGAAGCAGGT|CTTCTTAACATAGGTACATCGGGCTCACTG
GGTCGACGCCGTACGAAGCAGGTCGAGTCA|ACATAGGTACATCGGGCTCACTGAAGGCCG
GTCCCTTTATGGGTAAACGGTCTGTTATAT|TAGCAGTTTGACTATCGATTTGGTTAATAA
ACTCTCCATTACCGAGACCGTCGTATCAGG|GGTCGACGCCGTTGGTGTACCCAAACTCGT
CGCCGCGTCGCCCTAATTGCTGGTGTACCC|GAGGTAAGCGTTTCCTCCTATGAGGTTATC
CTCGTGGTCGACGCCGTAGACAACATGCCC|CTTCAGACCTGGCAGTGAAGTTACAACAGT
CGGGAATTAGCAGTTTGACTATCGATTTGG|AGAGTTGGGTCATTGGTGTACCCAAACTCG
TGAGCAAGGTAAGCTCTCGGGCTGTACGAT|CGACGCCGTGTACCCAAACTCGTGGTCGAC
GGGGCGGACAATCTGCGGATCTTCTTCAGA|GTTTGCCTCTATCTACTATCGCGAGTCGTC
TCGGTGAACCAGAGAGCCCTGTCGTAAGGG|AATCCTGCTAGGTCTAAACGAGACACAGAC
TTCAGACCTGGCAGTGAAGTTACAACAGTC|GTCGTCGCTTTCTATGCCGATTCGCCGCGT
CTGTCGTAAGGGGGACGGGGCGGACAATCT|CGAGACACAGACGGTAGTTTGCCTCTATCT
TATGAGGTTATCTCCAACTCACCACTTGGG|TACAGAACAAGAGCAGCCCTAACCGGGGCT
TCTATCTCCGACCCTGGTGTACCCAAACTC|GTCGCCCTAATTGCTGGTGTACCCAAACTC
GCTATTCTGAGCAAGGTAAGCTCTCGGGCT|TCGTGGTCGACGCCGTGTACCCAAACTCGT
CAGTCTATCTCCGACCCTGGTGTACCCAAA|CGCGTCGCCCTAATTGCTGGTGTACCCAAA
CCCTAATTGCTGGTGTACCCAAACTCGTGG|TTTCCTCCTATGAGGTTATCTCCAACTCAC
TACCCAAACTCGTGGTCGACGCCGTGTACC|CATTACCGAGACCGTCGTATCAGGCTACGG
TGGTGTACCCAAACTCGTGGTCGACGCCGT|TGGTGTACCCAAACTCGTGGTCGACGCCGT
GTTGGGTCATTGGTGTACCCAAACTCGTGG|ACGAATCCATAACCCTAAGGGCCTAGAGAC
GAGGTTAGAATCTAGAATCATTTAATTGGA|CCTAGGGTTCGGTGAACCAGAGAGCCCTGT
GTACCCAAACTCGTGGTCGACGCCGTGTAC|CCATTACCGAGACCGTCGTATCAGGCTACG
TGGTCGACGCCGTCTACAGAACAAGAGCAG|CATATGGTAGTTTCGCAATATTCTTCTGTC
CGCCGTTGGTGTACCCAAACTCGTGGTCGA|AGGTTAGAATCTAGAATCATTTAATTGGAT
TGGTGTACCCAAACTCGTGGTCGACGCCGT|ATGGTGTACCCAAACTCGTGGTCGACGCCG
AACTCGTGGTCGACGCCGTCGCATCAAGAG|CCATGGTGTACCCAAACTCGTGGTCGACGC
GTCTATCTCCGACCCTGGTGTACCCAAACT|CGTCGCCCTAATTGCTGGTGTACCCAAACT
GCCGTAATCCTGCTAGGTCTAAACGAGACA|GCCGTAGCTGGTCCCTTTATGGGTAAACGG
TAACAAGTTGGGGTGTCGAATAGCTATTCT|TTGGTGGTTGGTGTACCCAAACTCGTGGTC
GTCACCTAGGGTTCGGTGAACCAGAGAGCC|GGTCGACGCCGTAATCCTGCTAGGTCTAAA
AGAATCATTTAATTGGATCTCAGATTCAGA|GAACCAGAGAGCCCTGTCGTAAGGGGGACG
TCTAGGTTCGACACGCTCGCGTCACCTAGG|CCTGGTGTACCCAAACTCGTGGTCGACGCC
CGTAGCTGGTCCCTTTATGGGTAAACGGTC|GCGGGAATTAGCAGTTTGACTATCGATTTG
AACTCGTGGTCGACGCCGTAGGGGCTAACT|CATTTAATTGGATCTCAGATTCAGAAAGAT
GTGGTCGACGCCGTGTACCCAAACTCGTGG|CCGTCGTATCAGGCTACGGACCCCTGTTGT
TGGTCGACGCCGTAGACAACATGCCCCGCG|AGACCTGGCAGTGAAGTTACAACAGTCTAT
GTGTACCCAAACTCGTGGTCGACGCCGTAG|AGGTTATCTCCAACTCACCACTTGGGCGGG
GCGGATCTTCTTCAGACCTGGCAGTGAAGT|ACTATCGCGAGTCGTCGCTTTCTATGCCGA
TGTACCCAAACTCGTGGTCGACGCCGTAGG|CGCCGTACGAAGCAGGTCGAGTCAACTGTT
TACGGCTCTGCCGTAACAAGTTGGGGTGTC|TCGGGCTTGCCGTTTGGTGGTTGGTGTACC
GCCGTAACAAGTTGGGGTGTCGAATAGCTA|CCGTTTGGTGGTTGGTGTACCCAAACTCGT
ATTAGCAGTTTGACTATCGATTTGGTTAAT|TGGGTCATTGGTGTACCCAAACTCGTGGTC
TCGTGGTCGACGCCGTAATCCTGCTAGGTC|TCGTGGTCGACGCCGTAGCTGGTCCCTTTA
AGGTACGGCTCTGCCGTAACAAGTTGGGGT|GTCTCGGGCTTGCCGTTTGGTGGTTGGTGT
TTGATGAGGTAAGCGTTTCCTCCTATGAGG|CCAAACTCGTGGTCGACGCCGTCTACAGAA
ACCCAAACTCGTGGTCGACGCCGTAGACAA|GGATCTTCTTCAGACCTGGCAGTGAAGTTA
CACTGGTGTACCCAAACTCGTGGTCGACGC|TCTACTGGATATAACCATGGTGTACCCAAA
GTACCCAAACTCGTGGTCGACGCCGTCTGA|GTGCTCTAGGTTCGACACGCTCGCGTCACC
TGGTGTACCCAAACTCGTGGTCGACGCCGT|CAAACTCGTGGTCGACGCCGTCTGAGGTTA
GTGGTCGACGCCGTCTACAGAACAAGAGCA|ACATATGGTAGTTTCGCAATATTCTTCTGT
CACTCGCTCAAAAACTCTCCATTACCGAGA|TACCCAAACTCGTGGTCGACGCCGTTGGTG
CACCACTTGGGCGGGAATTAGCAGTTTGAC|TAACCGGGGCTAGAGTTGGGTCATTGGTGT
GCTCGCGTCACCTAGGGTTCGGTGAACCAG|ACTCGTGGTCGACGCCGTAATCCTGCTAGG
CGGGCTCACTGAAGGCCGGCTCTCCATATG|GTGTAACACCAGTTGTGTATGGTGTACCCA
CGCCGTTGTACCCAAACTCGTGGTCGACGC|GGGAAGCTACTAGACTTCTTAACATAGGTA
GTGGTCGACGCCGTCGCATCAAGAGGACCT|GTGTACCCAAACTCGTGGTCGACGCCGTAG
TCGTGGTCGACGCCGTGTACCCAAACTCGT|GACCGTCGTATCAGGCTACGGACCCCTGTT
TGTGCTCTAGGTTCGACACGCTCGCGTCAC|CCGACCCTGGTGTACCCAAACTCGTGGTCG
AAGCTCTCGGGCTGTACGATCTGAAGTCTA|TACCCAAACTCGTGGTCGACGCCGTTGTAC
GCTAACTAAATGGTGTACCCAAACTCGTGG|GAAAGATACAATGGTGTACCCAAACTCGTG
CGTGGTCGACGCCGTCTACAGAACAAGAGC|AACATATGGTAGTTTCGCAATATTCTTCTG
GCCGTAGCTGGTCCCTTTATGGGTAAACGG|GGGCGGGAATTAGCAGTTTGACTATCGATT
GTCAACTGTTTCAGTTGTACACTCGCTCAA|GCCGGCTCTCCATATGGTGTACCCAAACTC
ACCCAAACTCGTGGTCGACGCCGTCGCATC|TATAACCATGGTGTACCCAAACTCGTGGTC
GCGGGTGTGCTCTAGGTTCGACACGCTCGC|TATCTCCGACCCTGGTGTACCCAAACTCGT
CGCTCAAAAACTCTCCATTACCGAGACCGT|CAAACTCGTGGTCGACGCCGTTGGTGTACC
CTGGTGTACCCAAACTCGTGGTCGACGCCG|CTGGTGTACCCAAACTCGTGGTCGACGCCG
GTAGTTTGCCTCTATCTACTATCGCGAGTC|ATATGGTGTACCCAAACTCGTGGTCGACGC
GAACAAGAGCAGCCCTAACCGGGGCTAGAG|TATTCTTCTGTCCAAGGTCCCCCTAACATA
TCGACGCCGTTGGTGTACCCAAACTCGTGG|TCTGAGGTTAGAATCTAGAATCATTTAATT
GGTCGACGCCGTCGCATCAAGAGGACCTAG|GTACCCAAACTCGTGGTCGACGCCGTAGGT
ACAACAGTCTATCTCCGACCCTGGTGTACC|TCGCCGCGTCGCCCTAATTGCTGGTGTACC
ACAAGAGCAGCCCTAACCGGGGCTAGAGTT|TTCTTCTGTCCAAGGTCCCCCTAACATACG
AACAAGAGCAGCCCTAACCGGGGCTAGAGT|ATTCTTCTGTCCAAGGTCCCCCTAACATAC
GATGGGAAGCTACTAGACTTCTTAACATAG|TAACTAAATGGTGTACCCAAACTCGTGGTC
TACCCAAACTCGTGGTCGACGCCGTACGAA|ACTAGACTTCTTAACATAGGTACATCGGGC
TGGTCGACGCCGTACGAAGCAGGTCGAGTC|AACATAGGTACATCGGGCTCACTGAAGGCC
GTAAGCGTTTCCTCCTATGAGGTTATCTCC|GTGGTCGACGCCGTCTACAGAACAAGAGCA
GGTACGGCTCTGCCGTAACAAGTTGGGGTG|TCTCGGGCTTGCCGTTTGGTGGTTGGTGTA
GGCAGTGAAGTTACAACAGTCTATCTCCGA|TTCTATGCCGATTCGCCGCGTCGCCCTAAT
TTGTACCCAAACTCGTGGTCGACGCCGTAC|GCTACTAGACTTCTTAACATAGGTACATCG
CTCGTGGTCGACGCCGTTGGTGTACCCAAA|GACGCCGTCTGAGGTTAGAATCTAGAATCA
CCTCCTATGAGGTTATCTCCAACTCACCAC|CCGTCTACAGAACAAGAGCAGCCCTAACCG
TGTACCCAAACTCGTGGTCGACGCCGTCGC|GGATATAACCATGGTGTACCCAAACTCGTG
AAGGTAAGCTCTCGGGCTGTACGATCTGAA|CCGTGTACCCAAACTCGTGGTCGACGCCGT
TTCTCCACTGGTGTACCCAAACTCGTGGTC|TGAAGTCTACTGGATATAACCATGGTGTAC
CCTAATTGCTGGTGTACCCAAACTCGTGGT|TTCCTCCTATGAGGTTATCTCCAACTCACC
TCTGAGCAAGGTAAGCTCTCGGGCTGTACG|GTCGACGCCGTGTACCCAAACTCGTGGTCG
GACCCTGGTGTACCCAAACTCGTGGTCGAC|ATTGCTGGTGTACCCAAACTCGTGGTCGAC
TGGTCGACGCCGTGTAACACCAGTTGTGTA|GTGGTCGACGCCGTAGACAACATGCCCCGC
GCTACGGACCCCTGTTGTGGATGGGAAGCT|TGGTCGACGCCGTAGGGGCTAACTAAATGG
TGAGGTTATCTCCAACTCACCACTTGGGCG|CAGAACAAGAGCAGCCCTAACCGGGGCTAG
CCGACCCTGGTGTACCCAAACTCGTGGTCG|TAATTGCTGGTGTACCCAAACTCGTGGTCG
AAACTCGTGGTCGACGCCGTAGGGGCTAAC|TCATTTAATTGGATCTCAGATTCAGAAAGA
TACGAAGCAGGTCGAGTCAACTGTTTCAGT|TCGGGCTCACTGAAGGCCGGCTCTCCATAT
GGCTCACTGAAGGCCGGCTCTCCATATGGT|GTAACACCAGTTGTGTATGGTGTACCCAAA
GGGCTCACTGAAGGCCGGCTCTCCATATGG|TGTAACACCAGTTGTGTATGGTGTACCCAA
TTATGGGTAAACGGTCTGTTATATGGTGTA|TTTGACTATCGATTTGGTTAATAAGTTCAC
GGTTCGACACGCTCGCGTCACCTAGGGTTC|GTGTACCCAAACTCGTGGTCGACGCCGTAA
GTGTACCCAAACTCGTGGTCGACGCCGTAA|GTGTACCCAAACTCGTGGTCGACGCCGTAG
GGTGAACCAGAGAGCCCTGTCGTAAGGGGG|TCCTGCTAGGTCTAAACGAGACACAGACGG
CGTGTACCCAAACTCGTGGTCGACGCCGTT|GGCTACGGACCCCTGTTGTGGATGGGAAGC
TGCCGATTCGCCGCGTCGCCCTAATTGCTG|GGTTTGATGAGGTAAGCGTTTCCTCCTATG
TTTCCTCCTATGAGGTTATCTCCAACTCAC|ACGCCGTCTACAGAACAAGAGCAGCCCTAA
ACGCCGTTGGTGTACCCAAACTCGTGGTCG|GAGGTTAGAATCTAGAATCATTTAATTGGA
TCTACCTGGTGTACCCAAACTCGTGGTCGA|TGTCTCCAAGACGGTCTCATGAACATATGG
AGGTAAGCGTTTCCTCCTATGAGGTTATCT|TCGTGGTCGACGCCGTCTACAGAACAAGAG
GAGGTTATCTCCAACTCACCACTTGGGCGG|AGAACAAGAGCAGCCCTAACCGGGGCTAGA
GACGCCGTGTAACACCAGTTGTGTATGGTG|CGACGCCGTAGACAACATGCCCCGCGGGTG
TACTGGATATAACCATGGTGTACCCAAACT|ACCCAAACTCGTGGTCGACGCCGTACGAAG
AGTTCACAATGACATGTTCAGAATCTCTCT|ACGCCGTTCAACTTGACTGTTGTACGGTGT
TGAAGTTACAACAGTCTATCTCCGACCCTG|TGCCGATTCGCCGCGTCGCCCTAATTGCTG
ATGGTGTACCCAAACTCGTGGTCGACGCCG|AAGTTCACAATGACATGTTCAGAATCTCTC
ATGCCCCGCGGGTGTGCTCTAGGTTCGACA|AACAGTCTATCTCCGACCCTGGTGTACCCA
GGGAAGCTACTAGACTTCTTAACATAGGTA|CTAAATGGTGTACCCAAACTCGTGGTCGAC
CTTAACATAGGTACATCGGGCTCACTGAAG|ACTCGTGGTCGACGCCGTGTAACACCAGTT
TCGTGGTCGACGCCGTCTGAGGTTAGAATC|TTCGACACGCTCGCGTCACCTAGGGTTCGG
GTCATTGGTGTACCCAAACTCGTGGTCGAC|TCCATAACCCTAAGGGCCTAGAGACAATGT
TAGGGGCTAACTAAATGGTGTACCCAAACT|ATTCAGAAAGATACAATGGTGTACCCAAAC
GCTGAAAGGTTTGATGAGGTAAGCGTTTCC|CCTGGTGTACCCAAACTCGTGGTCGACGCC
TCGGGCTCACTGAAGGCCGGCTCTCCATAT|CGTGTAACACCAGTTGTGTATGGTGTACCC
TGAACCAGAGAGCCCTGTCGTAAGGGGGAC|CTGCTAGGTCTAAACGAGACACAGACGGTA
TATCTCCAACTCACCACTTGGGCGGGAATT|AAGAGCAGCCCTAACCGGGGCTAGAGTTGG
TATTCTGAGCAAGGTAAGCTCTCGGGCTGT|GTGGTCGACGCCGTGTACCCAAACTCGTGG
GTTATATGGTGTACCCAAACTCGTGGTCGA|TTAATAAGTTCACAATGACATGTTCAGAAT
TGTACCCAAACTCGTGGTCGACGCCGTGTA|GTGTACCCAAACTCGTGGTCGACGCCGTAG
TGATGAGGTAAGCGTTTCCTCCTATGAGGT|CAAACTCGTGGTCGACGCCGTCTACAGAAC
TGGTCGACGCCGTTGGTGTACCCAAACTCG|CCGTCTGAGGTTAGAATCTAGAATCATTTA
GGTCGACGCCGTTGGTGTACCCAAACTCGT|CGTCTGAGGTTAGAATCTAGAATCATTTAA
GCAGTTTGACTATCGATTTGGTTAATAAGT|TCATTGGTGTACCCAAACTCGTGGTCGACG
GCCGTGTAACACCAGTTGTGTATGGTGTAC|CGCCGTAGACAACATGCCCCGCGGGTGTGC
AGTTTGACTATCGATTTGGTTAATAAGTTC|ATTGGTGTACCCAAACTCGTGGTCGACGCC
CCGATTCGCCGCGTCGCCCTAATTGCTGGT|TTTGATGAGGTAAGCGTTTCCTCCTATGAG
AACTCTCCATTACCGAGACCGTCGTATCAG|TGGTCGACGCCGTTGGTGTACCCAAACTCG
GGTTCGGTGAACCAGAGAGCCCTGTCGTAA|CGTAATCCTGCTAGGTCTAAACGAGACACA
AAACTCGTGGTCGACGCCGTAGCTGGTCCC|TCCAACTCACCACTTGGGCGGGAATTAGCA
AGTCTATCTCCGACCCTGGTGTACCCAAAC|GCGTCGCCCTAATTGCTGGTGTACCCAAAC
CCCAAACTCGTGGTCGACGCCGTAGCTGGT|ATCTCCAACTCACCACTTGGGCGGGAATTA
CCAAACTCGTGGTCGACGCCGTGGCTGAAA|ATGACATGTTCAGAATCTCTCTACCTGGTG
CTGAGCAAGGTAAGCTCTCGGGCTGTACGA|TCGACGCCGTGTACCCAAACTCGTGGTCGA
CTCACTGAAGGCCGGCTCTCCATATGGTGT|AACACCAGTTGTGTATGGTGTACCCAAACT
CGCCGTGTACCCAAACTCGTGGTCGACGCC|TCAGGCTACGGACCCCTGTTGTGGATGGGA
CGACCCTGGTGTACCCAAACTCGTGGTCGA|AATTGCTGGTGTACCCAAACTCGTGGTCGA
CCAAACTCGTGGTCGACGCCGTGTACCCAA|TACCGAGACCGTCGTATCAGGCTACGGACC
TAGGTCTCGGGCTTGCCGTTTGGTGGTTGG|TGTTTCAGTTGTACACTCGCTCAAAAACTC
TCGTGGTCGACGCCGTAGACAACATGCCCC|TTCAGACCTGGCAGTGAAGTTACAACAGTC
TTCGACACGCTCGCGTCACCTAGGGTTCGG|GTACCCAAACTCGTGGTCGACGCCGTAATC
GCCGTGTACCCAAACTCGTGGTCGACGCCG|CAGGCTACGGACCCCTGTTGTGGATGGGAA
AATTGGATCTCAGATTCAGAAAGATACAAT|GCCCTGTCGTAAGGGGGACGGGGCGGACAA
TTTAATTGGATCTCAGATTCAGAAAGATAC|AGAGCCCTGTCGTAAGGGGGACGGGGCGGA
TTCTGAGCAAGGTAAGCTCTCGGGCTGTAC|GGTCGACGCCGTGTACCCAAACTCGTGGTC
CAGTTGTACACTCGCTCAAAAACTCTCCAT|ATATGGTGTACCCAAACTCGTGGTCGACGC
AAAACTCTCCATTACCGAGACCGTCGTATC|CGTGGTCGACGCCGTTGGTGTACCCAAACT
GTCTACTGGATATAACCATGGTGTACCCAA|TGTACCCAAACTCGTGGTCGACGCCGTACG
GACCTGGCAGTGAAGTTACAACAGTCTATC|TCGCTTTCTATGCCGATTCGCCGCGTCGCC
CGTGGTCGACGCCGTTGTACCCAAACTCGT|GTTGTGGATGGGAAGCTACTAGACTTCTTA
GAATAGCTATTCTGAGCAAGGTAAGCTCTC|CAAACTCGTGGTCGACGCCGTGTACCCAAA
AGGGTTCGGTGAACCAGAGAGCCCTGTCGT|GCCGTAATCCTGCTAGGTCTAAACGAGACA
TGTACCCAAACTCGTGGTCGACGCCGTGTA|TCCATTACCGAGACCGTCGTATCAGGCTAC
CTAAATGGTGTACCCAAACTCGTGGTCGAC|ATACAATGGTGTACCCAAACTCGTGGTCGA
AAACGGTCTGTTATATGGTGTACCCAAACT|TCGATTTGGTTAATAAGTTCACAATGACAT
GACGCCGTAGGTCTCGGGCTTGCCGTTTGG|AGTCAACTGTTTCAGTTGTACACTCGCTCA
TCGCCCTAATTGCTGGTGTACCCAAACTCG|GCGTTTCCTCCTATGAGGTTATCTCCAACT
GAAAGCTTCTCCACTGGTGTACCCAAACTC|ACGATCTGAAGTCTACTGGATATAACCATG
AAACTCGTGGTCGACGCCGTGGCTGAAAGG|GACATGTTCAGAATCTCTCTACCTGGTGTA
CTGTACGATCTGAAGTCTACTGGATATAAC|GTGGTCGACGCCGTTGTACCCAAACTCGTG
TGCCTCTATCTACTATCGCGAGTCGTCGCT|TGTACCCAAACTCGTGGTCGACGCCGTGGC
CGACGCCGTAGCTGGTCCCTTTATGGGTAA|ACTTGGGCGGGAATTAGCAGTTTGACTATC
CAGACGGTAGTTTGCCTCTATCTACTATCG|TCTGTTATATGGTGTACCCAAACTCGTGGT
CGAAGCAGGTCGAGTCAACTGTTTCAGTTG|GGGCTCACTGAAGGCCGGCTCTCCATATGG
TCGCGAGTCGTCGCTTTCTATGCCGATTCG|GGTCGACGCCGTGGCTGAAAGGTTTGATGA
AACCGGGGCTAGAGTTGGGTCATTGGTGTA|GTCCCCCTAACATACGAATCCATAACCCTA
CTACGGACCCCTGTTGTGGATGGGAAGCTA|GGTCGACGCCGTAGGGGCTAACTAAATGGT
AAACTCGTGGTCGACGCCGTAATCCTGCTA|AAACTCGTGGTCGACGCCGTAGCTGGTCCC
GTGCTCTAGGTTCGACACGCTCGCGTCACC|CGACCCTGGTGTACCCAAACTCGTGGTCGA
GCCGTCTACAGAACAAGAGCAGCCCTAACC|AGTTTCGCAATATTCTTCTGTCCAAGGTCC
CAAACTCGTGGTCGACGCCGTAGACAACAT|TCTTCTTCAGACCTGGCAGTGAAGTTACAA
ATCTCTCTACCTGGTGTACCCAAACTCGTG|TACGGTGTCTCCAAGACGGTCTCATGAACA
TATAACCATGGTGTACCCAAACTCGTGGTC|CTCGTGGTCGACGCCGTACGAAGCAGGTCG
GCTTCTCCACTGGTGTACCCAAACTCGTGG|TCTGAAGTCTACTGGATATAACCATGGTGT
TCTCCATTACCGAGACCGTCGTATCAGGCT|TCGACGCCGTTGGTGTACCCAAACTCGTGG
ACCCAAACTCGTGGTCGACGCCGTAGCTGG|TATCTCCAACTCACCACTTGGGCGGGAATT
TTGTGGATGGGAAGCTACTAGACTTCTTAA|GGGGCTAACTAAATGGTGTACCCAAACTCG
AGCTGGTCCCTTTATGGGTAAACGGTCTGT|GGAATTAGCAGTTTGACTATCGATTTGGTT
ATCTCCGACCCTGGTGTACCCAAACTCGTG|GCCCTAATTGCTGGTGTACCCAAACTCGTG
AAACTCGTGGTCGACGCCGTCGCATCAAGA|ACCATGGTGTACCCAAACTCGTGGTCGACG
CCCAAACTCGTGGTCGACGCCGTTGTACCC|GGACCCCTGTTGTGGATGGGAAGCTACTAG
ATTGCTGGTGTACCCAAACTCGTGGTCGAC|TCCTATGAGGTTATCTCCAACTCACCACTT
GGCTAACTAAATGGTGTACCCAAACTCGTG|AGAAAGATACAATGGTGTACCCAAACTCGT
ACCGGGGCTAGAGTTGGGTCATTGGTGTAC|TCCCCCTAACATACGAATCCATAACCCTAA
TGTCGTAAGGGGGACGGGGCGGACAATCTG|GAGACACAGACGGTAGTTTGCCTCTATCTA
CAATGACATGTTCAGAATCTCTCTACCTGG|TTCAACTTGACTGTTGTACGGTGTCTCCAA
GGTGTACCCAAACTCGTGGTCGACGCCGTC|AAGACGGTCTCATGAACATATGGTAGTTTC
AACTAAATGGTGTACCCAAACTCGTGGTCG|AGATACAATGGTGTACCCAAACTCGTGGTC
TCTAGAATCATTTAATTGGATCTCAGATTC|GGTGAACCAGAGAGCCCTGTCGTAAGGGGG
CAAACTCGTGGTCGACGCCGTTGGTGTACC|GGTCGACGCCGTCTGAGGTTAGAATCTAGA
TAGTTTGCCTCTATCTACTATCGCGAGTCG|TATGGTGTACCCAAACTCGTGGTCGACGCC
GCTGTACGATCTGAAGTCTACTGGATATAA|CGTGGTCGACGCCGTTGTACCCAAACTCGT
CTCCGACCCTGGTGTACCCAAACTCGTGGT|CCTAATTGCTGGTGTACCCAAACTCGTGGT
TAATCCTGCTAGGTCTAAACGAGACACAGA|TAGCTGGTCCCTTTATGGGTAAACGGTCTG
GCCGAAAGCTTCTCCACTGGTGTACCCAAA|TGTACGATCTGAAGTCTACTGGATATAACC
CTCGCGTCACCTAGGGTTCGGTGAACCAGA|CTCGTGGTCGACGCCGTAATCCTGCTAGGT
ACCGTCGTATCAGGCTACGGACCCCTGTTG|GTACCCAAACTCGTGGTCGACGCCGTAGGG
CAACAGTCTATCTCCGACCCTGGTGTACCC|CGCCGCGTCGCCCTAATTGCTGGTGTACCC
AACCAGAGAGCCCTGTCGTAAGGGGGACGG|GCTAGGTCTAAACGAGACACAGACGGTAGT
GCAGGTCGAGTCAACTGTTTCAGTTGTACA|TCACTGAAGGCCGGCTCTCCATATGGTGTA
GTAGGGGCTAACTAAATGGTGTACCCAAAC|GATTCAGAAAGATACAATGGTGTACCCAAA
TAATTGCTGGTGTACCCAAACTCGTGGTCG|CCTCCTATGAGGTTATCTCCAACTCACCAC
TACCCAAACTCGTGGTCGACGCCGTGTAAC|GTACCCAAACTCGTGGTCGACGCCGTAGAC
CTGGTGTACCCAAACTCGTGGTCGACGCCG|TACTGGATATAACCATGGTGTACCCAAACT
CTTCTCCACTGGTGTACCCAAACTCGTGGT|CTGAAGTCTACTGGATATAACCATGGTGTA
GATCTCAGATTCAGAAAGATACAATGGTGT|GTCGTAAGGGGGACGGGGCGGACAATCTGC
CCTATGAGGTTATCTCCAACTCACCACTTG|TCTACAGAACAAGAGCAGCCCTAACCGGGG
TGGCTGAAAGGTTTGATGAGGTAAGCGTTT|TACCTGGTGTACCCAAACTCGTGGTCGACG
GCGTCGCCCTAATTGCTGGTGTACCCAAAC|TAAGCGTTTCCTCCTATGAGGTTATCTCCA
GTTCGGTGAACCAGAGAGCCCTGTCGTAAG|GTAATCCTGCTAGGTCTAAACGAGACACAG
GGGTAAACGGTCTGTTATATGGTGTACCCA|ACTATCGATTTGGTTAATAAGTTCACAATG
GACGCCGTTGGTGTACCCAAACTCGTGGTC|TGAGGTTAGAATCTAGAATCATTTAATTGG
TACCCAAACTCGTGGTCGACGCCGTGGCTG|ACAATGACATGTTCAGAATCTCTCTACCTG
TGAAGGCCGGCTCTCCATATGGTGTACCCA|CAGTTGTGTATGGTGTACCCAAACTCGTGG
ATATAACCATGGTGTACCCAAACTCGTGGT|ACTCGTGGTCGACGCCGTACGAAGCAGGTC
TACAGAACAAGAGCAGCCCTAACCGGGGCT|GCAATATTCTTCTGTCCAAGGTCCCCCTAA
TACTAGACTTCTTAACATAGGTACATCGGG|GTGTACCCAAACTCGTGGTCGACGCCGTGT
TTCGGTGAACCAGAGAGCCCTGTCGTAAGG|TAATCCTGCTAGGTCTAAACGAGACACAGA
TGGTGTACCCAAACTCGTGGTCGACGCCGT|CAAGACGGTCTCATGAACATATGGTAGTTT
CGACGCCGTACGAAGCAGGTCGAGTCAACT|TAGGTACATCGGGCTCACTGAAGGCCGGCT
ATAGGTACATCGGGCTCACTGAAGGCCGGC|GGTCGACGCCGTGTAACACCAGTTGTGTAT
CCAAACTCGTGGTCGACGCCGTTGTACCCA|GACCCCTGTTGTGGATGGGAAGCTACTAGA
ACAGTCTATCTCCGACCCTGGTGTACCCAA|CCGCGTCGCCCTAATTGCTGGTGTACCCAA
GGTCGACGCCGTCTGAGGTTAGAATCTAGA|ACACGCTCGCGTCACCTAGGGTTCGGTGAA
CAGATTCAGAAAGATACAATGGTGTACCCA|AAGGGGGACGGGGCGGACAATCTGCGGATC
TCGACGCCGTAGGGGCTAACTAAATGGTGT|GGATCTCAGATTCAGAAAGATACAATGGTG
GTACCCAAACTCGTGGTCGACGCCGTAGGT|GCCGTACGAAGCAGGTCGAGTCAACTGTTT
CGTGGTCGACGCCGTAATCCTGCTAGGTCT|CGTGGTCGACGCCGTAGCTGGTCCCTTTAT
ATATGGTGTACCCAAACTCGTGGTCGACGC|ATAAGTTCACAATGACATGTTCAGAATCTC
GGTCCCTTTATGGGTAAACGGTCTGTTATA|TTAGCAGTTTGACTATCGATTTGGTTAATA
TCTGCCGTAACAAGTTGGGGTGTCGAATAG|TTGCCGTTTGGTGGTTGGTGTACCCAAACT
GCCGTTGGTGTACCCAAACTCGTGGTCGAC|GGTTAGAATCTAGAATCATTTAATTGGATC
TACCTGGTGTACCCAAACTCGTGGTCGACG|TCTCCAAGACGGTCTCATGAACATATGGTA
GCCGATTCGCCGCGTCGCCCTAATTGCTGG|GTTTGATGAGGTAAGCGTTTCCTCCTATGA
GAGTTGGGTCATTGGTGTACCCAAACTCGT|ATACGAATCCATAACCCTAAGGGCCTAGAG
AAAGGTTTGATGAGGTAAGCGTTTCCTCCT|GTGTACCCAAACTCGTGGTCGACGCCGTCT
TTGCCGTTTGGTGGTTGGTGTACCCAAACT|ACACTCGCTCAAAAACTCTCCATTACCGAG
GTAGGTCTCGGGCTTGCCGTTTGGTGGTTG|CTGTTTCAGTTGTACACTCGCTCAAAAACT
ACGCTCGCGTCACCTAGGGTTCGGTGAACC|AAACTCGTGGTCGACGCCGTAATCCTGCTA
AGGTCGAGTCAACTGTTTCAGTTGTACACT|ACTGAAGGCCGGCTCTCCATATGGTGTACC
CTTCTTCAGACCTGGCAGTGAAGTTACAAC|GCGAGTCGTCGCTTTCTATGCCGATTCGCC
CTGAGGTTAGAATCTAGAATCATTTAATTG|CACCTAGGGTTCGGTGAACCAGAGAGCCCT
CAGTTTGACTATCGATTTGGTTAATAAGTT|CATTGGTGTACCCAAACTCGTGGTCGACGC
CTATTCTGAGCAAGGTAAGCTCTCGGGCTG|CGTGGTCGACGCCGTGTACCCAAACTCGTG
TGGTGTACCCAAACTCGTGGTCGACGCCGT|TGAGGTTATCTCCAACTCACCACTTGGGCG
GAGACACAGACGGTAGTTTGCCTCTATCTA|AAACGGTCTGTTATATGGTGTACCCAAACT
GTCTCGGGCTTGCCGTTTGGTGGTTGGTGT|TTCAGTTGTACACTCGCTCAAAAACTCTCC
GCGGGAATTAGCAGTTTGACTATCGATTTG|TAGAGTTGGGTCATTGGTGTACCCAAACTC
TTGGTTAATAAGTTCACAATGACATGTTCA|CTCGTGGTCGACGCCGTTCAACTTGACTGT
CCCTAACCGGGGCTAGAGTTGGGTCATTGG|CAAGGTCCCCCTAACATACGAATCCATAAC
GACCGTCGTATCAGGCTACGGACCCCTGTT|TGTACCCAAACTCGTGGTCGACGCCGTAGG
CAAACTCGTGGTCGACGCCGTTGTACCCAA|ACCCCTGTTGTGGATGGGAAGCTACTAGAC
CTCGTGGTCGACGCCGTCGCATCAAGAGGA|ATGGTGTACCCAAACTCGTGGTCGACGCCG
TCGGGCTTGCCGTTTGGTGGTTGGTGTACC|AGTTGTACACTCGCTCAAAAACTCTCCATT
GTCGAATAGCTATTCTGAGCAAGGTAAGCT|ACCCAAACTCGTGGTCGACGCCGTGTACCC
GGTCTCGGGCTTGCCGTTTGGTGGTTGGTG|TTTCAGTTGTACACTCGCTCAAAAACTCTC
CCCAAACTCGTGGTCGACGCCGTAGGGGCT|GAATCATTTAATTGGATCTCAGATTCAGAA
CCAAACTCGTGGTCGACGCCGTAGGGGCTA|AATCATTTAATTGGATCTCAGATTCAGAAA
TGAGCCGAAAGCTTCTCCACTGGTGTACCC|GGCTGTACGATCTGAAGTCTACTGGATATA
ACGCCGTCTACAGAACAAGAGCAGCCCTAA|GTAGTTTCGCAATATTCTTCTGTCCAAGGT
ACGCCGTCTGAGGTTAGAATCTAGAATCAT|CTCGCGTCACCTAGGGTTCGGTGAACCAGA
CGCCGTACGAAGCAGGTCGAGTCAACTGTT|GTACATCGGGCTCACTGAAGGCCGGCTCTC
TCTATGCCGATTCGCCGCGTCGCCCTAATT|GAAAGGTTTGATGAGGTAAGCGTTTCCTCC
CCTAGGGTTCGGTGAACCAGAGAGCCCTGT|GACGCCGTAATCCTGCTAGGTCTAAACGAG
CTTGCCGTTTGGTGGTTGGTGTACCCAAAC|TACACTCGCTCAAAAACTCTCCATTACCGA
AAGAGGACCTAGGTACGGCTCTGCCGTAAC|GACGCCGTAGGTCTCGGGCTTGCCGTTTGG
TCGACGCCGTAGGTCTCGGGCTTGCCGTTT|CGAGTCAACTGTTTCAGTTGTACACTCGCT
AGGGGCTAACTAAATGGTGTACCCAAACTC|TTCAGAAAGATACAATGGTGTACCCAAACT
CTGAAGGCCGGCTCTCCATATGGTGTACCC|CCAGTTGTGTATGGTGTACCCAAACTCGTG
GGTTATCTCCAACTCACCACTTGGGCGGGA|AACAAGAGCAGCCCTAACCGGGGCTAGAGT
CCTGGTGTACCCAAACTCGTGGTCGACGCC|TCCAAGACGGTCTCATGAACATATGGTAGT
TTCACAATGACATGTTCAGAATCTCTCTAC|GCCGTTCAACTTGACTGTTGTACGGTGTCT
ATGGTGTACCCAAACTCGTGGTCGACGCCG|AATGGTGTACCCAAACTCGTGGTCGACGCC
CCCTGTCGTAAGGGGGACGGGGCGGACAAT|AACGAGACACAGACGGTAGTTTGCCTCTAT
TCATTTAATTGGATCTCAGATTCAGAAAGA|CAGAGAGCCCTGTCGTAAGGGGGACGGGGC
TTAACATAGGTACATCGGGCTCACTGAAGG|CTCGTGGTCGACGCCGTGTAACACCAGTTG
AGGACCTAGGTACGGCTCTGCCGTAACAAG|GCCGTAGGTCTCGGGCTTGCCGTTTGGTGG
CGTGGTCGACGCCGTGTAACACCAGTTGTG|TCGTGGTCGACGCCGTAGACAACATGCCCC
GTGGCTGAAAGGTTTGATGAGGTAAGCGTT|CTACCTGGTGTACCCAAACTCGTGGTCGAC
GTGTCGAATAGCTATTCTGAGCAAGGTAAG|GTACCCAAACTCGTGGTCGACGCCGTGTAC
ACGCCGTAGCTGGTCCCTTTATGGGTAAAC|TTGGGCGGGAATTAGCAGTTTGACTATCGA
TCTCAGATTCAGAAAGATACAATGGTGTAC|CGTAAGGGGGACGGGGCGGACAATCTGCGG
ACGGTCTGTTATATGGTGTACCCAAACTCG|GATTTGGTTAATAAGTTCACAATGACATGT
TGCCGTTTGGTGGTTGGTGTACCCAAACTC|CACTCGCTCAAAAACTCTCCATTACCGAGA
TACCCAAACTCGTGGTCGACGCCGTAGGTC|CCGTACGAAGCAGGTCGAGTCAACTGTTTC
TTAGAATCTAGAATCATTTAATTGGATCTC|GGGTTCGGTGAACCAGAGAGCCCTGTCGTA
ACTGGATATAACCATGGTGTACCCAAACTC|CCCAAACTCGTGGTCGACGCCGTACGAAGC
CACCAGTTGTGTATGGTGTACCCAAACTCG|CAACATGCCCCGCGGGTGTGCTCTAGGTTC
AACTCGTGGTCGACGCCGTCTGAGGTTAGA|AGGTTCGACACGCTCGCGTCACCTAGGGTT
TACATCGGGCTCACTGAAGGCCGGCTCTCC|ACGCCGTGTAACACCAGTTGTGTATGGTGT
GTGTACCCAAACTCGTGGTCGACGCCGTGT|GGTGTACCCAAACTCGTGGTCGACGCCGTA
ACATGTTCAGAATCTCTCTACCTGGTGTAC|CTTGACTGTTGTACGGTGTCTCCAAGACGG
GCCGTAGGTCTCGGGCTTGCCGTTTGGTGG|CAACTGTTTCAGTTGTACACTCGCTCAAAA
CGTTGTACCCAAACTCGTGGTCGACGCCGT|AAGCTACTAGACTTCTTAACATAGGTACAT
GAAGTTACAACAGTCTATCTCCGACCCTGG|GCCGATTCGCCGCGTCGCCCTAATTGCTGG
GTCTGAGGTTAGAATCTAGAATCATTTAAT|GTCACCTAGGGTTCGGTGAACCAGAGAGCC
AATCTGCGGATCTTCTTCAGACCTGGCAGT|TATCTACTATCGCGAGTCGTCGCTTTCTAT
AAGGTTTGATGAGGTAAGCGTTTCCTCCTA|TGTACCCAAACTCGTGGTCGACGCCGTCTA
CATCGGGCTCACTGAAGGCCGGCTCTCCAT|GCCGTGTAACACCAGTTGTGTATGGTGTAC
GAACCAGAGAGCCCTGTCGTAAGGGGGACG|TGCTAGGTCTAAACGAGACACAGACGGTAG
GTGTACCCAAACTCGTGGTCGACGCCGTCG|TGGATATAACCATGGTGTACCCAAACTCGT
CCACTGGTGTACCCAAACTCGTGGTCGACG|GTCTACTGGATATAACCATGGTGTACCCAA
ACTCGTGGTCGACGCCGTTGTACCCAAACT|CCTGTTGTGGATGGGAAGCTACTAGACTTC
CGATCTGAAGTCTACTGGATATAACCATGG|CGACGCCGTTGTACCCAAACTCGTGGTCGA
GGTGTACCCAAACTCGTGGTCGACGCCGTG|GTTCACAATGACATGTTCAGAATCTCTCTA
TGGTCGACGCCGTAGGTCTCGGGCTTGCCG|GGTCGAGTCAACTGTTTCAGTTGTACACTC
ATGGTGTACCCAAACTCGTGGTCGACGCCG|CGGGTGTGCTCTAGGTTCGACACGCTCGCG
GGCTCTCCATATGGTGTACCCAAACTCGTG|TATGGTGTACCCAAACTCGTGGTCGACGCC
TGGTGTACCCAAACTCGTGGTCGACGCCGT|AGTTCACAATGACATGTTCAGAATCTCTCT
AGGCCGGCTCTCCATATGGTGTACCCAAAC|TTGTGTATGGTGTACCCAAACTCGTGGTCG
ACCCAAACTCGTGGTCGACGCCGTGTAACA|TACCCAAACTCGTGGTCGACGCCGTAGACA
ACCTAGGGTTCGGTGAACCAGAGAGCCCTG|CGACGCCGTAATCCTGCTAGGTCTAAACGA
GGTGTACCCAAACTCGTGGTCGACGCCGTG|TCTCCATTACCGAGACCGTCGTATCAGGCT
CGGTGAACCAGAGAGCCCTGTCGTAAGGGG|ATCCTGCTAGGTCTAAACGAGACACAGACG
CGCCGTCGCATCAAGAGGACCTAGGTACGG|AAACTCGTGGTCGACGCCGTAGGTCTCGGG
CAAACTCGTGGTCGACGCCGTGTAACACCA|CCAAACTCGTGGTCGACGCCGTAGACAACA
AGTCTACTGGATATAACCATGGTGTACCCA|TTGTACCCAAACTCGTGGTCGACGCCGTAC
TGTACCCAAACTCGTGGTCGACGCCGTTCA|CCTAAGGGCCTAGAGACAATGTCATACATC
AACTCGTGGTCGACGCCGTGTAACACCAGT|AAACTCGTGGTCGACGCCGTAGACAACATG
GCCCTGTCGTAAGGGGGACGGGGCGGACAA|AAACGAGACACAGACGGTAGTTTGCCTCTA
TGGTTGGTGTACCCAAACTCGTGGTCGACG|AAAACTCTCCATTACCGAGACCGTCGTATC
TTTGCCTCTATCTACTATCGCGAGTCGTCG|GGTGTACCCAAACTCGTGGTCGACGCCGTG
AACTCGTGGTCGACGCCGTAATCCTGCTAG|AACTCGTGGTCGACGCCGTAGCTGGTCCCT
CTCGTGGTCGACGCCGTAGCTGGTCCCTTT|AACTCACCACTTGGGCGGGAATTAGCAGTT
AGAGAGCCCTGTCGTAAGGGGGACGGGGCG|GGTCTAAACGAGACACAGACGGTAGTTTGC
CTAGAGTTGGGTCATTGGTGTACCCAAACT|AACATACGAATCCATAACCCTAAGGGCCTA
CGTTTCCTCCTATGAGGTTATCTCCAACTC|CGACGCCGTCTACAGAACAAGAGCAGCCCT
AAGCGTTTCCTCCTATGAGGTTATCTCCAA|GGTCGACGCCGTCTACAGAACAAGAGCAGC
CCGTCTACAGAACAAGAGCAGCCCTAACCG|GTTTCGCAATATTCTTCTGTCCAAGGTCCC
TAGAGTTGGGTCATTGGTGTACCCAAACTC|ACATACGAATCCATAACCCTAAGGGCCTAG
GACGGGGCGGACAATCTGCGGATCTTCTTC|GTAGTTTGCCTCTATCTACTATCGCGAGTC
TGCGGATCTTCTTCAGACCTGGCAGTGAAG|TACTATCGCGAGTCGTCGCTTTCTATGCCG
TGCCGTAACAAGTTGGGGTGTCGAATAGCT|GCCGTTTGGTGGTTGGTGTACCCAAACTCG
TGAAAGGTTTGATGAGGTAAGCGTTTCCTC|TGGTGTACCCAAACTCGTGGTCGACGCCGT
GGAAGCTACTAGACTTCTTAACATAGGTAC|TAAATGGTGTACCCAAACTCGTGGTCGACG
CGTGGTCGACGCCGTAGACAACATGCCCCG|TCAGACCTGGCAGTGAAGTTACAACAGTCT
TCTACTATCGCGAGTCGTCGCTTTCTATGC|AACTCGTGGTCGACGCCGTGGCTGAAAGGT
ACTCACCACTTGGGCGGGAATTAGCAGTTT|CCCTAACCGGGGCTAGAGTTGGGTCATTGG
AACGAGACACAGACGGTAGTTTGCCTCTAT|GGTAAACGGTCTGTTATATGGTGTACCCAA
CGTGGCTGAAAGGTTTGATGAGGTAAGCGT|TCTACCTGGTGTACCCAAACTCGTGGTCGA
AATGGTGTACCCAAACTCGTGGTCGACGCC|CAATCTGCGGATCTTCTTCAGACCTGGCAG
TCGTGGTCGACGCCGTGGCTGAAAGGTTTG|TGTTCAGAATCTCTCTACCTGGTGTACCCA
GACCTAGGTACGGCTCTGCCGTAACAAGTT|CGTAGGTCTCGGGCTTGCCGTTTGGTGGTT
GTCGACGCCGTAATCCTGCTAGGTCTAAAC|GTCGACGCCGTAGCTGGTCCCTTTATGGGT
GAATCTCTCTACCTGGTGTACCCAAACTCG|TGTACGGTGTCTCCAAGACGGTCTCATGAA
ACGCCGTACGAAGCAGGTCGAGTCAACTGT|GGTACATCGGGCTCACTGAAGGCCGGCTCT
GGACGGGGCGGACAATCTGCGGATCTTCTT|GGTAGTTTGCCTCTATCTACTATCGCGAGT
CTCTAGGTTCGACACGCTCGCGTCACCTAG|CCCTGGTGTACCCAAACTCGTGGTCGACGC
CCATGGTGTACCCAAACTCGTGGTCGACGC|GGTCGACGCCGTACGAAGCAGGTCGAGTCA
GCCGTCTGAGGTTAGAATCTAGAATCATTT|CGCGTCACCTAGGGTTCGGTGAACCAGAGA
AAGTTACAACAGTCTATCTCCGACCCTGGT|CCGATTCGCCGCGTCGCCCTAATTGCTGGT
TGGTGTACCCAAACTCGTGGTCGACGCCGT|ACTGGATATAACCATGGTGTACCCAAACTC
TTGTGTATGGTGTACCCAAACTCGTGGTCG|GCCCCGCGGGTGTGCTCTAGGTTCGACACG
TAGACAACATGCCCCGCGGGTGTGCTCTAG|GAAGTTACAACAGTCTATCTCCGACCCTGG
TGTACCCAAACTCGTGGTCGACGCCGTTGG|ACTCGTGGTCGACGCCGTCTGAGGTTAGAA
AGCCCTGTCGTAAGGGGGACGGGGCGGACA|TAAACGAGACACAGACGGTAGTTTGCCTCT
CTCAGATTCAGAAAGATACAATGGTGTACC|GTAAGGGGGACGGGGCGGACAATCTGCGGA
CGTAGACAACATGCCCCGCGGGTGTGCTCT|GTGAAGTTACAACAGTCTATCTCCGACCCT
GTGGTCGACGCCGTGGCTGAAAGGTTTGAT|TTCAGAATCTCTCTACCTGGTGTACCCAAA
GGGTCATTGGTGTACCCAAACTCGTGGTCG|AATCCATAACCCTAAGGGCCTAGAGACAAT
TCGTGGTCGACGCCGTGTAACACCAGTTGT|CTCGTGGTCGACGCCGTAGACAACATGCCC
CCCAAACTCGTGGTCGACGCCGTCTGAGGT|CTCTAGGTTCGACACGCTCGCGTCACCTAG
GCTCAAAAACTCTCCATTACCGAGACCGTC|AAACTCGTGGTCGACGCCGTTGGTGTACCC
GGTGTACCCAAACTCGTGGTCGACGCCGTA|GGTGTACCCAAACTCGTGGTCGACGCCGTA
ATAAGTTCACAATGACATGTTCAGAATCTC|TCGACGCCGTTCAACTTGACTGTTGTACGG
TCGTGGTCGACGCCGTAGGTCTCGGGCTTG|GCAGGTCGAGTCAACTGTTTCAGTTGTACA
ATTGGATCTCAGATTCAGAAAGATACAATG|CCCTGTCGTAAGGGGGACGGGGCGGACAAT
CGACGCCGTAGGGGCTAACTAAATGGTGTA|GATCTCAGATTCAGAAAGATACAATGGTGT
TCTGTTATATGGTGTACCCAAACTCGTGGT|TGGTTAATAAGTTCACAATGACATGTTCAG
GTAGACAACATGCCCCGCGGGTGTGCTCTA|TGAAGTTACAACAGTCTATCTCCGACCCTG
TTAGCAGTTTGACTATCGATTTGGTTAATA|GGGTCATTGGTGTACCCAAACTCGTGGTCG
TTTCTATGCCGATTCGCCGCGTCGCCCTAA|CTGAAAGGTTTGATGAGGTAAGCGTTTCCT
CTCTCTACCTGGTGTACCCAAACTCGTGGT|CGGTGTCTCCAAGACGGTCTCATGAACATA
GACGGTAGTTTGCCTCTATCTACTATCGCG|TGTTATATGGTGTACCCAAACTCGTGGTCG
CTAATTGCTGGTGTACCCAAACTCGTGGTC|TCCTCCTATGAGGTTATCTCCAACTCACCA
CGACGCCGTAGACAACATGCCCCGCGGGTG|CTGGCAGTGAAGTTACAACAGTCTATCTCC
TAAGTTCACAATGACATGTTCAGAATCTCT|CGACGCCGTTCAACTTGACTGTTGTACGGT
ATCTGAAGTCTACTGGATATAACCATGGTG|ACGCCGTTGTACCCAAACTCGTGGTCGACG
CGTAACAAGTTGGGGTGTCGAATAGCTATT|GTTTGGTGGTTGGTGTACCCAAACTCGTGG
ACAATGGTGTACCCAAACTCGTGGTCGACG|GACAATCTGCGGATCTTCTTCAGACCTGGC
GTAAGCTCTCGGGCTGTACGATCTGAAGTC|TGTACCCAAACTCGTGGTCGACGCCGTTGT
TCAGAAAGATACAATGGTGTACCCAAACTC|GGACGGGGCGGACAATCTGCGGATCTTCTT
TTGGGGTGTCGAATAGCTATTCTGAGCAAG|TTGGTGTACCCAAACTCGTGGTCGACGCCG
GTCGACGCCGTCTGAGGTTAGAATCTAGAA|CACGCTCGCGTCACCTAGGGTTCGGTGAAC
AACTCGTGGTCGACGCCGTTGGTGTACCCA|TCGACGCCGTCTGAGGTTAGAATCTAGAAT
ATCGGGCTCACTGAAGGCCGGCTCTCCATA|CCGTGTAACACCAGTTGTGTATGGTGTACC
TCAAGAGGACCTAGGTACGGCTCTGCCGTA|TCGACGCCGTAGGTCTCGGGCTTGCCGTTT
AGGTTAGAATCTAGAATCATTTAATTGGAT|CTAGGGTTCGGTGAACCAGAGAGCCCTGTC
TATCTCCGACCCTGGTGTACCCAAACTCGT|CGCCCTAATTGCTGGTGTACCCAAACTCGT
CGCCGTAGACAACATGCCCCGCGGGTGTGC|GCAGTGAAGTTACAACAGTCTATCTCCGAC
GTTGGTGTACCCAAACTCGTGGTCGACGCC|AACTCTCCATTACCGAGACCGTCGTATCAG
AGACACAGACGGTAGTTTGCCTCTATCTAC|AACGGTCTGTTATATGGTGTACCCAAACTC
TCTCCAACTCACCACTTGGGCGGGAATTAG|GAGCAGCCCTAACCGGGGCTAGAGTTGGGT
AAACTCGTGGTCGACGCCGTCTACAGAACA|TCATGAACATATGGTAGTTTCGCAATATTC
CTAGGTACGGCTCTGCCGTAACAAGTTGGG|AGGTCTCGGGCTTGCCGTTTGGTGGTTGGT
CCCTGGTGTACCCAAACTCGTGGTCGACGC|TGCTGGTGTACCCAAACTCGTGGTCGACGC
CTTTATGGGTAAACGGTCTGTTATATGGTG|AGTTTGACTATCGATTTGGTTAATAAGTTC
GTGGTCGACGCCGTAGGGGCTAACTAAATG|AATTGGATCTCAGATTCAGAAAGATACAAT
TCTTAACATAGGTACATCGGGCTCACTGAA|AACTCGTGGTCGACGCCGTGTAACACCAGT
ATGTTCAGAATCTCTCTACCTGGTGTACCC|TGACTGTTGTACGGTGTCTCCAAGACGGTC
CACTTGGGCGGGAATTAGCAGTTTGACTAT|CCGGGGCTAGAGTTGGGTCATTGGTGTACC
AAAGCTTCTCCACTGGTGTACCCAAACTCG|CGATCTGAAGTCTACTGGATATAACCATGG
ATTCGCCGCGTCGCCCTAATTGCTGGTGTA|GATGAGGTAAGCGTTTCCTCCTATGAGGTT
CAGAATCTCTCTACCTGGTGTACCCAAACT|GTTGTACGGTGTCTCCAAGACGGTCTCATG
CCAAACTCGTGGTCGACGCCGTAGCTGGTC|TCTCCAACTCACCACTTGGGCGGGAATTAG
ATCATTTAATTGGATCTCAGATTCAGAAAG|CCAGAGAGCCCTGTCGTAAGGGGGACGGGG
CTGGTGTACCCAAACTCGTGGTCGACGCCG|ATGAGGTTATCTCCAACTCACCACTTGGGC
TGAAGTCTACTGGATATAACCATGGTGTAC|CCGTTGTACCCAAACTCGTGGTCGACGCCG
CTGGTGTACCCAAACTCGTGGTCGACGCCG|CCAAGACGGTCTCATGAACATATGGTAGTT
CGCCGTCTGAGGTTAGAATCTAGAATCATT|TCGCGTCACCTAGGGTTCGGTGAACCAGAG
AGCAGGTCGAGTCAACTGTTTCAGTTGTAC|CTCACTGAAGGCCGGCTCTCCATATGGTGT
TTGGATCTCAGATTCAGAAAGATACAATGG|CCTGTCGTAAGGGGGACGGGGCGGACAATC
TACCCAAACTCGTGGTCGACGCCGTCTACA|CGGTCTCATGAACATATGGTAGTTTCGCAA
CAAACTCGTGGTCGACGCCGTAGCTGGTCC|CTCCAACTCACCACTTGGGCGGGAATTAGC
TACCCAAACTCGTGGTCGACGCCGTTGGTG|TCGTGGTCGACGCCGTCTGAGGTTAGAATC
AGTTGTGTATGGTGTACCCAAACTCGTGGT|ATGCCCCGCGGGTGTGCTCTAGGTTCGACA
TGTACACTCGCTCAAAAACTCTCCATTACC|GGTGTACCCAAACTCGTGGTCGACGCCGTT
GAGCCGAAAGCTTCTCCACTGGTGTACCCA|GCTGTACGATCTGAAGTCTACTGGATATAA
CCAACTCACCACTTGGGCGGGAATTAGCAG|CAGCCCTAACCGGGGCTAGAGTTGGGTCAT
ATCTTCTTCAGACCTGGCAGTGAAGTTACA|TCGCGAGTCGTCGCTTTCTATGCCGATTCG
GTCTGTTATATGGTGTACCCAAACTCGTGG|TTGGTTAATAAGTTCACAATGACATGTTCA
GTTGGTGTACCCAAACTCGTGGTCGACGCC|TAGAATCTAGAATCATTTAATTGGATCTCA
ACACAGACGGTAGTTTGCCTCTATCTACTA|CGGTCTGTTATATGGTGTACCCAAACTCGT
TGTGGATGGGAAGCTACTAGACTTCTTAAC|GGGCTAACTAAATGGTGTACCCAAACTCGT
AGGTCTAAACGAGACACAGACGGTAGTTTG|CTTTATGGGTAAACGGTCTGTTATATGGTG
TGGTCGACGCCGTGTACCCAAACTCGTGGT|CGTCGTATCAGGCTACGGACCCCTGTTGTG
GGGTTCGGTGAACCAGAGAGCCCTGTCGTA|CCGTAATCCTGCTAGGTCTAAACGAGACAC
GAAGCTACTAGACTTCTTAACATAGGTACA|AAATGGTGTACCCAAACTCGTGGTCGACGC
ACTGTTTCAGTTGTACACTCGCTCAAAAAC|GCTCTCCATATGGTGTACCCAAACTCGTGG
ACCCAAACTCGTGGTCGACGCCGTTGTACC|CGGACCCCTGTTGTGGATGGGAAGCTACTA
CGTACGAAGCAGGTCGAGTCAACTGTTTCA|CATCGGGCTCACTGAAGGCCGGCTCTCCAT
TTTGATGAGGTAAGCGTTTCCTCCTATGAG|CCCAAACTCGTGGTCGACGCCGTCTACAGA
GACTTCTTAACATAGGTACATCGGGCTCAC|CCCAAACTCGTGGTCGACGCCGTGTAACAC
AATCATTTAATTGGATCTCAGATTCAGAAA|ACCAGAGAGCCCTGTCGTAAGGGGGACGGG
GGTGGTTGGTGTACCCAAACTCGTGGTCGA|CAAAAACTCTCCATTACCGAGACCGTCGTA
ACTCGTGGTCGACGCCGTGTACCCAAACTC|GAGACCGTCGTATCAGGCTACGGACCCCTG
TACCCAAACTCGTGGTCGACGCCGTCGCAT|ATATAACCATGGTGTACCCAAACTCGTGGT
TCCGACCCTGGTGTACCCAAACTCGTGGTC|CTAATTGCTGGTGTACCCAAACTCGTGGTC
GGGGACGGGGCGGACAATCTGCGGATCTTC|ACGGTAGTTTGCCTCTATCTACTATCGCGA
GTGTACCCAAACTCGTGGTCGACGCCGTAG|CTGCGGATCTTCTTCAGACCTGGCAGTGAA
CTCGTGGTCGACGCCGTCTGAGGTTAGAAT|GTTCGACACGCTCGCGTCACCTAGGGTTCG
AGCAGCCCTAACCGGGGCTAGAGTTGGGTC|CTGTCCAAGGTCCCCCTAACATACGAATCC
CTAACTAAATGGTGTACCCAAACTCGTGGT|AAAGATACAATGGTGTACCCAAACTCGTGG
AATCTCTCTACCTGGTGTACCCAAACTCGT|GTACGGTGTCTCCAAGACGGTCTCATGAAC
GGACAATCTGCGGATCTTCTTCAGACCTGG|CCTCTATCTACTATCGCGAGTCGTCGCTTT
GTGTACCCAAACTCGTGGTCGACGCCGTAG|ATCTAGAATCATTTAATTGGATCTCAGATT
CCCAAACTCGTGGTCGACGCCGTTGGTGTA|GTGGTCGACGCCGTCTGAGGTTAGAATCTA
ACTCGTGGTCGACGCCGTAATCCTGCTAGG|ACTCGTGGTCGACGCCGTAGCTGGTCCCTT
TGGGAAGCTACTAGACTTCTTAACATAGGT|ACTAAATGGTGTACCCAAACTCGTGGTCGA
CATCAAGAGGACCTAGGTACGGCTCTGCCG|GGTCGACGCCGTAGGTCTCGGGCTTGCCGT
CACTGAAGGCCGGCTCTCCATATGGTGTAC|CACCAGTTGTGTATGGTGTACCCAAACTCG
GCTCTAGGTTCGACACGCTCGCGTCACCTA|ACCCTGGTGTACCCAAACTCGTGGTCGACG
TCAGACCTGGCAGTGAAGTTACAACAGTCT|TCGTCGCTTTCTATGCCGATTCGCCGCGTC
TGCTGGTGTACCCAAACTCGTGGTCGACGC|CTATGAGGTTATCTCCAACTCACCACTTGG
GGTGTACCCAAACTCGTGGTCGACGCCGTA|TCTGCGGATCTTCTTCAGACCTGGCAGTGA
ACTTGGGCGGGAATTAGCAGTTTGACTATC|CGGGGCTAGAGTTGGGTCATTGGTGTACCC
GCCCTAATTGCTGGTGTACCCAAACTCGTG|GTTTCCTCCTATGAGGTTATCTCCAACTCA
CCTCTATCTACTATCGCGAGTCGTCGCTTT|TACCCAAACTCGTGGTCGACGCCGTGGCTG
ACCTGGCAGTGAAGTTACAACAGTCTATCT|CGCTTTCTATGCCGATTCGCCGCGTCGCCC
GACACGCTCGCGTCACCTAGGGTTCGGTGA|CCCAAACTCGTGGTCGACGCCGTAATCCTG
GTACGATCTGAAGTCTACTGGATATAACCA|GGTCGACGCCGTTGTACCCAAACTCGTGGT
CTCTCGGGCTGTACGATCTGAAGTCTACTG|CCAAACTCGTGGTCGACGCCGTTGTACCCA
TGTACCCAAACTCGTGGTCGACGCCGTAGC|GGTTATCTCCAACTCACCACTTGGGCGGGA
TGGATCTCAGATTCAGAAAGATACAATGGT|CTGTCGTAAGGGGGACGGGGCGGACAATCT
GTTGTACACTCGCTCAAAAACTCTCCATTA|ATGGTGTACCCAAACTCGTGGTCGACGCCG
TTGGGTCATTGGTGTACCCAAACTCGTGGT|CGAATCCATAACCCTAAGGGCCTAGAGACA
GAATTAGCAGTTTGACTATCGATTTGGTTA|GTTGGGTCATTGGTGTACCCAAACTCGTGG
CGCGTCGCCCTAATTGCTGGTGTACCCAAA|GTAAGCGTTTCCTCCTATGAGGTTATCTCC
GTGTACCCAAACTCGTGGTCGACGCCGTAG|ACGCCGTACGAAGCAGGTCGAGTCAACTGT
GCTCTCCATATGGTGTACCCAAACTCGTGG|ATGGTGTACCCAAACTCGTGGTCGACGCCG
ACGCCGTAGGGGCTAACTAAATGGTGTACC|TCTCAGATTCAGAAAGATACAATGGTGTAC
ACGCCGTGGCTGAAAGGTTTGATGAGGTAA|TCTCTCTACCTGGTGTACCCAAACTCGTGG
GGTGTACCCAAACTCGTGGTCGACGCCGTA|GACGCCGTACGAAGCAGGTCGAGTCAACTG
GTTGTGGATGGGAAGCTACTAGACTTCTTA|AGGGGCTAACTAAATGGTGTACCCAAACTC
AGGTTCGACACGCTCGCGTCACCTAGGGTT|GGTGTACCCAAACTCGTGGTCGACGCCGTA
CATTGGTGTACCCAAACTCGTGGTCGACGC|CATAACCCTAAGGGCCTAGAGACAATGTCA
GACATGTTCAGAATCTCTCTACCTGGTGTA|ACTTGACTGTTGTACGGTGTCTCCAAGACG
TACAATGGTGTACCCAAACTCGTGGTCGAC|GGACAATCTGCGGATCTTCTTCAGACCTGG
ACCCCTGTTGTGGATGGGAAGCTACTAGAC|CGCCGTAGGGGCTAACTAAATGGTGTACCC
TGTACCCAAACTCGTGGTCGACGCCGTGGC|TCACAATGACATGTTCAGAATCTCTCTACC
GTACGAAGCAGGTCGAGTCAACTGTTTCAG|ATCGGGCTCACTGAAGGCCGGCTCTCCATA
GGACCTAGGTACGGCTCTGCCGTAACAAGT|CCGTAGGTCTCGGGCTTGCCGTTTGGTGGT
GTACCCAAACTCGTGGTCGACGCCGTGTAA|TGTACCCAAACTCGTGGTCGACGCCGTAGA
CGTATCAGGCTACGGACCCCTGTTGTGGAT|CAAACTCGTGGTCGACGCCGTAGGGGCTAA
GCTGGTCCCTTTATGGGTAAACGGTCTGTT|GAATTAGCAGTTTGACTATCGATTTGGTTA
AACTCGTGGTCGACGCCGTGGCTGAAAGGT|ACATGTTCAGAATCTCTCTACCTGGTGTAC
CTATCTCCGACCCTGGTGTACCCAAACTCG|TCGCCCTAATTGCTGGTGTACCCAAACTCG
CCGTTGTACCCAAACTCGTGGTCGACGCCG|GAAGCTACTAGACTTCTTAACATAGGTACA
AACATAGGTACATCGGGCTCACTGAAGGCC|CGTGGTCGACGCCGTGTAACACCAGTTGTG
AGCAGTTTGACTATCGATTTGGTTAATAAG|GTCATTGGTGTACCCAAACTCGTGGTCGAC
ATACAATGGTGTACCCAAACTCGTGGTCGA|CGGACAATCTGCGGATCTTCTTCAGACCTG
TAATTGGATCTCAGATTCAGAAAGATACAA|AGCCCTGTCGTAAGGGGGACGGGGCGGACA
CCGTAACAAGTTGGGGTGTCGAATAGCTAT|CGTTTGGTGGTTGGTGTACCCAAACTCGTG
TCGCTCAAAAACTCTCCATTACCGAGACCG|CCAAACTCGTGGTCGACGCCGTTGGTGTAC
TCTGCGGATCTTCTTCAGACCTGGCAGTGA|TCTACTATCGCGAGTCGTCGCTTTCTATGC
ATGAGGTTATCTCCAACTCACCACTTGGGC|ACAGAACAAGAGCAGCCCTAACCGGGGCTA
AATGACATGTTCAGAATCTCTCTACCTGGT|TCAACTTGACTGTTGTACGGTGTCTCCAAG
TGTACCCAAACTCGTGGTCGACGCCGTAGA|TGCGGATCTTCTTCAGACCTGGCAGTGAAG
ATAACCATGGTGTACCCAAACTCGTGGTCG|TCGTGGTCGACGCCGTACGAAGCAGGTCGA
GCCCTAACCGGGGCTAGAGTTGGGTCATTG|CCAAGGTCCCCCTAACATACGAATCCATAA
ACACCAGTTGTGTATGGTGTACCCAAACTC|ACAACATGCCCCGCGGGTGTGCTCTAGGTT
GGGGCTAACTAAATGGTGTACCCAAACTCG|TCAGAAAGATACAATGGTGTACCCAAACTC
GTCGCATCAAGAGGACCTAGGTACGGCTCT|TCGTGGTCGACGCCGTAGGTCTCGGGCTTG
TCGACGCCGTTGTACCCAAACTCGTGGTCG|GGATGGGAAGCTACTAGACTTCTTAACATA
GCAAGGTAAGCTCTCGGGCTGTACGATCTG|CGCCGTGTACCCAAACTCGTGGTCGACGCC
TGGGCGGGAATTAGCAGTTTGACTATCGAT|GGCTAGAGTTGGGTCATTGGTGTACCCAAA
TAGGTTCGACACGCTCGCGTCACCTAGGGT|TGGTGTACCCAAACTCGTGGTCGACGCCGT
CCCAAACTCGTGGTCGACGCCGTAATCCTG|CCCAAACTCGTGGTCGACGCCGTAGCTGGT
GTGGTCGACGCCGTTGTACCCAAACTCGTG|TTGTGGATGGGAAGCTACTAGACTTCTTAA
ATCGCGAGTCGTCGCTTTCTATGCCGATTC|TGGTCGACGCCGTGGCTGAAAGGTTTGATG
CTCTCCATTACCGAGACCGTCGTATCAGGC|GTCGACGCCGTTGGTGTACCCAAACTCGTG
CGTCGCTTTCTATGCCGATTCGCCGCGTCG|CCGTGGCTGAAAGGTTTGATGAGGTAAGCG
GCCGTAGACAACATGCCCCGCGGGTGTGCT|CAGTGAAGTTACAACAGTCTATCTCCGACC
ACTCGTGGTCGACGCCGTAGACAACATGCC|TCTTCAGACCTGGCAGTGAAGTTACAACAG
CTCAAAAACTCTCCATTACCGAGACCGTCG|AACTCGTGGTCGACGCCGTTGGTGTACCCA
CGACGCCGTTGTACCCAAACTCGTGGTCGA|GATGGGAAGCTACTAGACTTCTTAACATAG
CGTAGGTCTCGGGCTTGCCGTTTGGTGGTT|ACTGTTTCAGTTGTACACTCGCTCAAAAAC
CGAGACACAGACGGTAGTTTGCCTCTATCT|TAAACGGTCTGTTATATGGTGTACCCAAAC
TTACCGAGACCGTCGTATCAGGCTACGGAC|CCGTTGGTGTACCCAAACTCGTGGTCGACG
TGGCAGTGAAGTTACAACAGTCTATCTCCG|TTTCTATGCCGATTCGCCGCGTCGCCCTAA
ACTATCGATTTGGTTAATAAGTTCACAATG|GTACCCAAACTCGTGGTCGACGCCGTTCAA
CCCAAACTCGTGGTCGACGCCGTGTACCCA|TTACCGAGACCGTCGTATCAGGCTACGGAC
CGGGTGTGCTCTAGGTTCGACACGCTCGCG|ATCTCCGACCCTGGTGTACCCAAACTCGTG
GGTAGTTTGCCTCTATCTACTATCGCGAGT|TATATGGTGTACCCAAACTCGTGGTCGACG
ACCCAAACTCGTGGTCGACGCCGTCTGAGG|GCTCTAGGTTCGACACGCTCGCGTCACCTA
CTAGGTTCGACACGCTCGCGTCACCTAGGG|CTGGTGTACCCAAACTCGTGGTCGACGCCG
TACCCAAACTCGTGGTCGACGCCGTCTGAG|TGCTCTAGGTTCGACACGCTCGCGTCACCT
ACATGCCCCGCGGGTGTGCTCTAGGTTCGA|ACAACAGTCTATCTCCGACCCTGGTGTACC
TCGTGGTCGACGCCGTAGGGGCTAACTAAA|TTAATTGGATCTCAGATTCAGAAAGATACA
CCGTCTGAGGTTAGAATCTAGAATCATTTA|GCGTCACCTAGGGTTCGGTGAACCAGAGAG
GGTCGACGCCGTGTAACACCAGTTGTGTAT|TGGTCGACGCCGTAGACAACATGCCCCGCG
CCAAACTCGTGGTCGACGCCGTGTAACACC|CCCAAACTCGTGGTCGACGCCGTAGACAAC
CCCTTTATGGGTAAACGGTCTGTTATATGG|GCAGTTTGACTATCGATTTGGTTAATAAGT
GGTAAACGGTCTGTTATATGGTGTACCCAA|CTATCGATTTGGTTAATAAGTTCACAATGA
CAAGAGCAGCCCTAACCGGGGCTAGAGTTG|TCTTCTGTCCAAGGTCCCCCTAACATACGA
AATGGTGTACCCAAACTCGTGGTCGACGCC|CAATGGTGTACCCAAACTCGTGGTCGACGC
CTCGTGGTCGACGCCGTTGTACCCAAACTC|CTGTTGTGGATGGGAAGCTACTAGACTTCT
AGACCTGGCAGTGAAGTTACAACAGTCTAT|GTCGCTTTCTATGCCGATTCGCCGCGTCGC
AGCTCTCGGGCTGTACGATCTGAAGTCTAC|ACCCAAACTCGTGGTCGACGCCGTTGTACC
AACTCGTGGTCGACGCCGTGTACCCAAACT|CGAGACCGTCGTATCAGGCTACGGACCCCT
GGTCGACGCCGTGGCTGAAAGGTTTGATGA|CAGAATCTCTCTACCTGGTGTACCCAAACT
TATGGTGTACCCAAACTCGTGGTCGACGCC|TAAGTTCACAATGACATGTTCAGAATCTCT
AGAGCAGCCCTAACCGGGGCTAGAGTTGGG|TTCTGTCCAAGGTCCCCCTAACATACGAAT
GTTAGAATCTAGAATCATTTAATTGGATCT|AGGGTTCGGTGAACCAGAGAGCCCTGTCGT
GGTTGGTGTACCCAAACTCGTGGTCGACGC|AAACTCTCCATTACCGAGACCGTCGTATCA
ATGGGAAGCTACTAGACTTCTTAACATAGG|AACTAAATGGTGTACCCAAACTCGTGGTCG
CGACGCCGTGTAACACCAGTTGTGTATGGT|TCGACGCCGTAGACAACATGCCCCGCGGGT
AAGTCTACTGGATATAACCATGGTGTACCC|GTTGTACCCAAACTCGTGGTCGACGCCGTA
TGGTCGACGCCGTGGCTGAAAGGTTTGATG|TCAGAATCTCTCTACCTGGTGTACCCAAAC
GAAAGGTTTGATGAGGTAAGCGTTTCCTCC|GGTGTACCCAAACTCGTGGTCGACGCCGTC
GTACCCAAACTCGTGGTCGACGCCGTACGA|TACTAGACTTCTTAACATAGGTACATCGGG
ACTCGTGGTCGACGCCGTCTACAGAACAAG|ATGAACATATGGTAGTTTCGCAATATTCTT
AGACAACATGCCCCGCGGGTGTGCTCTAGG|AAGTTACAACAGTCTATCTCCGACCCTGGT
CGACGCCGTCGCATCAAGAGGACCTAGGTA|CCCAAACTCGTGGTCGACGCCGTAGGTCTC
ACCCAAACTCGTGGTCGACGCCGTGGCTGA|CAATGACATGTTCAGAATCTCTCTACCTGG
GTGGATGGGAAGCTACTAGACTTCTTAACA|GGCTAACTAAATGGTGTACCCAAACTCGTG
ACAACATGCCCCGCGGGTGTGCTCTAGGTT|GTTACAACAGTCTATCTCCGACCCTGGTGT
TCGACGCCGTGTACCCAAACTCGTGGTCGA|CGTATCAGGCTACGGACCCCTGTTGTGGAT
GAGGTAAGCGTTTCCTCCTATGAGGTTATC|CTCGTGGTCGACGCCGTCTACAGAACAAGA
GAGCAGCCCTAACCGGGGCTAGAGTTGGGT|TCTGTCCAAGGTCCCCCTAACATACGAATC
GCTACTAGACTTCTTAACATAGGTACATCG|TGGTGTACCCAAACTCGTGGTCGACGCCGT
CAAACTCGTGGTCGACGCCGTAATCCTGCT|CAAACTCGTGGTCGACGCCGTAGCTGGTCC
TCGGGCTGTACGATCTGAAGTCTACTGGAT|AACTCGTGGTCGACGCCGTTGTACCCAAAC
CGTTGGTGTACCCAAACTCGTGGTCGACGC|TTAGAATCTAGAATCATTTAATTGGATCTC
CCTGGCAGTGAAGTTACAACAGTCTATCTC|GCTTTCTATGCCGATTCGCCGCGTCGCCCT
GGGCGGACAATCTGCGGATCTTCTTCAGAC|TTTGCCTCTATCTACTATCGCGAGTCGTCG
TCGACGCCGTAGCTGGTCCCTTTATGGGTA|CACTTGGGCGGGAATTAGCAGTTTGACTAT
TGGTGTACCCAAACTCGTGGTCGACGCCGT|CGACGCCGTACGAAGCAGGTCGAGTCAACT
TCCTCCTATGAGGTTATCTCCAACTCACCA|GCCGTCTACAGAACAAGAGCAGCCCTAACC
GTCTAAACGAGACACAGACGGTAGTTTGCC|TTATGGGTAAACGGTCTGTTATATGGTGTA
CGCATCAAGAGGACCTAGGTACGGCTCTGC|GTGGTCGACGCCGTAGGTCTCGGGCTTGCC
ATCAGGCTACGGACCCCTGTTGTGGATGGG|ACTCGTGGTCGACGCCGTAGGGGCTAACTA
GTGTACCCAAACTCGTGGTCGACGCCGTGT|CTCCATTACCGAGACCGTCGTATCAGGCTA
AAACTCGTGGTCGACGCCGTAGACAACATG|CTTCTTCAGACCTGGCAGTGAAGTTACAAC
CGGCTCTCCATATGGTGTACCCAAACTCGT|GTATGGTGTACCCAAACTCGTGGTCGACGC
TGTATGGTGTACCCAAACTCGTGGTCGACG|CCGCGGGTGTGCTCTAGGTTCGACACGCTC
GATATAACCATGGTGTACCCAAACTCGTGG|AACTCGTGGTCGACGCCGTACGAAGCAGGT
GCTGGTGTACCCAAACTCGTGGTCGACGCC|TATGAGGTTATCTCCAACTCACCACTTGGG
CGCCGTGTAACACCAGTTGTGTATGGTGTA|ACGCCGTAGACAACATGCCCCGCGGGTGTG
ACGCCGTGTACCCAAACTCGTGGTCGACGC|ATCAGGCTACGGACCCCTGTTGTGGATGGG
GGGAATTAGCAGTTTGACTATCGATTTGGT|GAGTTGGGTCATTGGTGTACCCAAACTCGT
GACGCCGTCTGAGGTTAGAATCTAGAATCA|GCTCGCGTCACCTAGGGTTCGGTGAACCAG
ATCTGCGGATCTTCTTCAGACCTGGCAGTG|ATCTACTATCGCGAGTCGTCGCTTTCTATG
GGTACATCGGGCTCACTGAAGGCCGGCTCT|CGACGCCGTGTAACACCAGTTGTGTATGGT
GGGCTAGAGTTGGGTCATTGGTGTACCCAA|CCTAACATACGAATCCATAACCCTAAGGGC
CTTCTTAACATAGGTACATCGGGCTCACTG|CAAACTCGTGGTCGACGCCGTGTAACACCA
TAAATGGTGTACCCAAACTCGTGGTCGACG|TACAATGGTGTACCCAAACTCGTGGTCGAC
TGTGTATGGTGTACCCAAACTCGTGGTCGA|CCCCGCGGGTGTGCTCTAGGTTCGACACGC
CGCGTCACCTAGGGTTCGGTGAACCAGAGA|CGTGGTCGACGCCGTAATCCTGCTAGGTCT
CGTGTAACACCAGTTGTGTATGGTGTACCC|CCGTAGACAACATGCCCCGCGGGTGTGCTC
GCTTTCTATGCCGATTCGCCGCGTCGCCCT|GGCTGAAAGGTTTGATGAGGTAAGCGTTTC
ACGAGACACAGACGGTAGTTTGCCTCTATC|GTAAACGGTCTGTTATATGGTGTACCCAAA
TCGATTTGGTTAATAAGTTCACAATGACAT|CCAAACTCGTGGTCGACGCCGTTCAACTTG
CGGGGCGGACAATCTGCGGATCTTCTTCAG|AGTTTGCCTCTATCTACTATCGCGAGTCGT
GTTGTGTATGGTGTACCCAAACTCGTGGTC|TGCCCCGCGGGTGTGCTCTAGGTTCGACAC
TGGTCGACGCCGTAATCCTGCTAGGTCTAA|TGGTCGACGCCGTAGCTGGTCCCTTTATGG
GGGCGGGAATTAGCAGTTTGACTATCGATT|GCTAGAGTTGGGTCATTGGTGTACCCAAAC
CTCTATCTACTATCGCGAGTCGTCGCTTTC|ACCCAAACTCGTGGTCGACGCCGTGGCTGA
GCAGCCCTAACCGGGGCTAGAGTTGGGTCA|TGTCCAAGGTCCCCCTAACATACGAATCCA
CGTTTGGTGGTTGGTGTACCCAAACTCGTG|TCGCTCAAAAACTCTCCATTACCGAGACCG
CTCGTGGTCGACGCCGTGTACCCAAACTCG|AGACCGTCGTATCAGGCTACGGACCCCTGT
AACTGTTTCAGTTGTACACTCGCTCAAAAA|GGCTCTCCATATGGTGTACCCAAACTCGTG
GTAATCCTGCTAGGTCTAAACGAGACACAG|GTAGCTGGTCCCTTTATGGGTAAACGGTCT
ATGAGGTAAGCGTTTCCTCCTATGAGGTTA|AACTCGTGGTCGACGCCGTCTACAGAACAA
TGGTCGACGCCGTTGTACCCAAACTCGTGG|TGTGGATGGGAAGCTACTAGACTTCTTAAC
CTCCTATGAGGTTATCTCCAACTCACCACT|CGTCTACAGAACAAGAGCAGCCCTAACCGG
TCGTGGTCGACGCCGTTGTACCCAAACTCG|TGTTGTGGATGGGAAGCTACTAGACTTCTT
GGTGTACCCAAACTCGTGGTCGACGCCGTC|CTGGATATAACCATGGTGTACCCAAACTCG
TGTTATATGGTGTACCCAAACTCGTGGTCG|GTTAATAAGTTCACAATGACATGTTCAGAA
GTGTACCCAAACTCGTGGTCGACGCCGTTG|GCTACGGACCCCTGTTGTGGATGGGAAGCT
GTTACAACAGTCTATCTCCGACCCTGGTGT|GATTCGCCGCGTCGCCCTAATTGCTGGTGT
TCGAATAGCTATTCTGAGCAAGGTAAGCTC|CCCAAACTCGTGGTCGACGCCGTGTACCCA
GTCGACGCCGTTGTACCCAAACTCGTGGTC|TGGATGGGAAGCTACTAGACTTCTTAACAT
TCTTCTTCAGACCTGGCAGTGAAGTTACAA|CGCGAGTCGTCGCTTTCTATGCCGATTCGC
CCGTAGCTGGTCCCTTTATGGGTAAACGGT|GGCGGGAATTAGCAGTTTGACTATCGATTT
AGATTCAGAAAGATACAATGGTGTACCCAA|AGGGGGACGGGGCGGACAATCTGCGGATCT
GGACCCCTGTTGTGGATGGGAAGCTACTAG|GACGCCGTAGGGGCTAACTAAATGGTGTAC
GTCGACGCCGTAGACAACATGCCCCGCGGG|ACCTGGCAGTGAAGTTACAACAGTCTATCT
CCTGTTGTGGATGGGAAGCTACTAGACTTC|CGTAGGGGCTAACTAAATGGTGTACCCAAA
ACAAGTTGGGGTGTCGAATAGCTATTCTGA|GGTGGTTGGTGTACCCAAACTCGTGGTCGA
TGACATGTTCAGAATCTCTCTACCTGGTGT|AACTTGACTGTTGTACGGTGTCTCCAAGAC
TCGTCGCTTTCTATGCCGATTCGCCGCGTC|GCCGTGGCTGAAAGGTTTGATGAGGTAAGC
CTAGAATCATTTAATTGGATCTCAGATTCA|GTGAACCAGAGAGCCCTGTCGTAAGGGGGA
CTAAACGAGACACAGACGGTAGTTTGCCTC|ATGGGTAAACGGTCTGTTATATGGTGTACC
CCCAAACTCGTGGTCGACGCCGTGGCTGAA|AATGACATGTTCAGAATCTCTCTACCTGGT
AACAGTCTATCTCCGACCCTGGTGTACCCA|GCCGCGTCGCCCTAATTGCTGGTGTACCCA
ATTTAATTGGATCTCAGATTCAGAAAGATA|GAGAGCCCTGTCGTAAGGGGGACGGGGCGG
TAGAATCTAGAATCATTTAATTGGATCTCA|GGTTCGGTGAACCAGAGAGCCCTGTCGTAA
GCGGACAATCTGCGGATCTTCTTCAGACCT|TGCCTCTATCTACTATCGCGAGTCGTCGCT
GAGTCGTCGCTTTCTATGCCGATTCGCCGC|GACGCCGTGGCTGAAAGGTTTGATGAGGTA
CCTGGTGTACCCAAACTCGTGGTCGACGCC|GCTGGTGTACCCAAACTCGTGGTCGACGCC
ACATCGGGCTCACTGAAGGCCGGCTCTCCA|CGCCGTGTAACACCAGTTGTGTATGGTGTA
CTGAAAGGTTTGATGAGGTAAGCGTTTCCT|CTGGTGTACCCAAACTCGTGGTCGACGCCG
GTGTACCCAAACTCGTGGTCGACGCCGTTG|AACTCGTGGTCGACGCCGTCTGAGGTTAGA
GCAGTGAAGTTACAACAGTCTATCTCCGAC|TCTATGCCGATTCGCCGCGTCGCCCTAATT
CGCTTTCTATGCCGATTCGCCGCGTCGCCC|TGGCTGAAAGGTTTGATGAGGTAAGCGTTT
CGAAAGCTTCTCCACTGGTGTACCCAAACT|TACGATCTGAAGTCTACTGGATATAACCAT
TGGTGTACCCAAACTCGTGGTCGACGCCGT|GGGTGTGCTCTAGGTTCGACACGCTCGCGT
AGTTGGGTCATTGGTGTACCCAAACTCGTG|TACGAATCCATAACCCTAAGGGCCTAGAGA
TACCCAAACTCGTGGTCGACGCCGTAGGGG|TAGAATCATTTAATTGGATCTCAGATTCAG
CTTCAGACCTGGCAGTGAAGTTACAACAGT|AGTCGTCGCTTTCTATGCCGATTCGCCGCG
AGCAAGGTAAGCTCTCGGGCTGTACGATCT|ACGCCGTGTACCCAAACTCGTGGTCGACGC
TTCTTCAGACCTGGCAGTGAAGTTACAACA|CGAGTCGTCGCTTTCTATGCCGATTCGCCG
TCGACGCCGTAATCCTGCTAGGTCTAAACG|TCGACGCCGTAGCTGGTCCCTTTATGGGTA
CAGAAAGATACAATGGTGTACCCAAACTCG|GACGGGGCGGACAATCTGCGGATCTTCTTC
TCGCTTTCTATGCCGATTCGCCGCGTCGCC|GTGGCTGAAAGGTTTGATGAGGTAAGCGTT
CACCTAGGGTTCGGTGAACCAGAGAGCCCT|TCGACGCCGTAATCCTGCTAGGTCTAAACG
ATCGATTTGGTTAATAAGTTCACAATGACA|CCCAAACTCGTGGTCGACGCCGTTCAACTT
GGTCTAAACGAGACACAGACGGTAGTTTGC|TTTATGGGTAAACGGTCTGTTATATGGTGT
TGCCCCGCGGGTGTGCTCTAGGTTCGACAC|ACAGTCTATCTCCGACCCTGGTGTACCCAA
TCCATATGGTGTACCCAAACTCGTGGTCGA|TGTACCCAAACTCGTGGTCGACGCCGTCTG
TCCTATGAGGTTATCTCCAACTCACCACTT|GTCTACAGAACAAGAGCAGCCCTAACCGGG
CTAACCGGGGCTAGAGTTGGGTCATTGGTG|AGGTCCCCCTAACATACGAATCCATAACCC
GGCTTGCCGTTTGGTGGTTGGTGTACCCAA|TGTACACTCGCTCAAAAACTCTCCATTACC
TAAGCGTTTCCTCCTATGAGGTTATCTCCA|TGGTCGACGCCGTCTACAGAACAAGAGCAG
TCTCGGGCTTGCCGTTTGGTGGTTGGTGTA|TCAGTTGTACACTCGCTCAAAAACTCTCCA
CGATTCGCCGCGTCGCCCTAATTGCTGGTG|TTGATGAGGTAAGCGTTTCCTCCTATGAGG
CGTGGTCGACGCCGTAGCTGGTCCCTTTAT|CTCACCACTTGGGCGGGAATTAGCAGTTTG
TGTCGAATAGCTATTCTGAGCAAGGTAAGC|TACCCAAACTCGTGGTCGACGCCGTGTACC
GGATATAACCATGGTGTACCCAAACTCGTG|AAACTCGTGGTCGACGCCGTACGAAGCAGG
AAGATACAATGGTGTACCCAAACTCGTGGT|GGGCGGACAATCTGCGGATCTTCTTCAGAC
CGACGCCGTGTACCCAAACTCGTGGTCGAC|GTATCAGGCTACGGACCCCTGTTGTGGATG
TCGTGGTCGACGCCGTCGCATCAAGAGGAC|TGGTGTACCCAAACTCGTGGTCGACGCCGT
GACGCCGTACGAAGCAGGTCGAGTCAACTG|AGGTACATCGGGCTCACTGAAGGCCGGCTC
GAGTCAACTGTTTCAGTTGTACACTCGCTC|AGGCCGGCTCTCCATATGGTGTACCCAAAC
GACGCCGTTGTACCCAAACTCGTGGTCGAC|ATGGGAAGCTACTAGACTTCTTAACATAGG
AAACTCGTGGTCGACGCCGTCTGAGGTTAG|TAGGTTCGACACGCTCGCGTCACCTAGGGT
GGTGTACCCAAACTCGTGGTCGACGCCGTA|AATCTAGAATCATTTAATTGGATCTCAGAT
CTCGTGGTCGACGCCGTACGAAGCAGGTCG|TCTTAACATAGGTACATCGGGCTCACTGAA
ACGATCTGAAGTCTACTGGATATAACCATG|TCGACGCCGTTGTACCCAAACTCGTGGTCG
GAAGCAGGTCGAGTCAACTGTTTCAGTTGT|GGCTCACTGAAGGCCGGCTCTCCATATGGT
TAGCTATTCTGAGCAAGGTAAGCTCTCGGG|ACTCGTGGTCGACGCCGTGTACCCAAACTC
CGACGCCGTGGCTGAAAGGTTTGATGAGGT|AATCTCTCTACCTGGTGTACCCAAACTCGT
CTTGGGCGGGAATTAGCAGTTTGACTATCG|GGGGCTAGAGTTGGGTCATTGGTGTACCCA
GGCTGAAAGGTTTGATGAGGTAAGCGTTTC|ACCTGGTGTACCCAAACTCGTGGTCGACGC
CCGTAGGTCTCGGGCTTGCCGTTTGGTGGT|AACTGTTTCAGTTGTACACTCGCTCAAAAA
TCTCGGGCTGTACGATCTGAAGTCTACTGG|CAAACTCGTGGTCGACGCCGTTGTACCCAA
AGAGGACCTAGGTACGGCTCTGCCGTAACA|ACGCCGTAGGTCTCGGGCTTGCCGTTTGGT
TTGCCTCTATCTACTATCGCGAGTCGTCGC|GTGTACCCAAACTCGTGGTCGACGCCGTGG
TCAGTTGTACACTCGCTCAAAAACTCTCCA|CATATGGTGTACCCAAACTCGTGGTCGACG
TCAACTGTTTCAGTTGTACACTCGCTCAAA|CCGGCTCTCCATATGGTGTACCCAAACTCG
ATGGTGTACCCAAACTCGTGGTCGACGCCG|AATCTGCGGATCTTCTTCAGACCTGGCAGT
GTCGTATCAGGCTACGGACCCCTGTTGTGG|CCCAAACTCGTGGTCGACGCCGTAGGGGCT
GGTTAGAATCTAGAATCATTTAATTGGATC|TAGGGTTCGGTGAACCAGAGAGCCCTGTCG
GGTCGAGTCAACTGTTTCAGTTGTACACTC|CTGAAGGCCGGCTCTCCATATGGTGTACCC
CAATGGTGTACCCAAACTCGTGGTCGACGC|ACAATCTGCGGATCTTCTTCAGACCTGGCA
AGATACAATGGTGTACCCAAACTCGTGGTC|GGCGGACAATCTGCGGATCTTCTTCAGACC
AGGCTACGGACCCCTGTTGTGGATGGGAAG|CGTGGTCGACGCCGTAGGGGCTAACTAAAT
ACCCAAACTCGTGGTCGACGCCGTTCAACT|AAGGGCCTAGAGACAATGTCATACATCAGT
TAAACGAGACACAGACGGTAGTTTGCCTCT|TGGGTAAACGGTCTGTTATATGGTGTACCC
GTACCCAAACTCGTGGTCGACGCCGTAGGG|CTAGAATCATTTAATTGGATCTCAGATTCA
TCGTGGTCGACGCCGTAGCTGGTCCCTTTA|ACTCACCACTTGGGCGGGAATTAGCAGTTT
CAGACCTGGCAGTGAAGTTACAACAGTCTA|CGTCGCTTTCTATGCCGATTCGCCGCGTCG
TAGCTGGTCCCTTTATGGGTAAACGGTCTG|GGGAATTAGCAGTTTGACTATCGATTTGGT
GATTCGCCGCGTCGCCCTAATTGCTGGTGT|TGATGAGGTAAGCGTTTCCTCCTATGAGGT
TCACCTAGGGTTCGGTGAACCAGAGAGCCC|GTCGACGCCGTAATCCTGCTAGGTCTAAAC
CCAAACTCGTGGTCGACGCCGTCTACAGAA|TCTCATGAACATATGGTAGTTTCGCAATAT
GTTCGACACGCTCGCGTCACCTAGGGTTCG|TGTACCCAAACTCGTGGTCGACGCCGTAAT
AAGAGCAGCCCTAACCGGGGCTAGAGTTGG|CTTCTGTCCAAGGTCCCCCTAACATACGAA
GTAACAAGTTGGGGTGTCGAATAGCTATTC|TTTGGTGGTTGGTGTACCCAAACTCGTGGT
CATTACCGAGACCGTCGTATCAGGCTACGG|CGCCGTTGGTGTACCCAAACTCGTGGTCGA
GAGAGCCCTGTCGTAAGGGGGACGGGGCGG|GTCTAAACGAGACACAGACGGTAGTTTGCC
TAACCATGGTGTACCCAAACTCGTGGTCGA|CGTGGTCGACGCCGTACGAAGCAGGTCGAG
CTGTTATATGGTGTACCCAAACTCGTGGTC|GGTTAATAAGTTCACAATGACATGTTCAGA
CTACTAGACTTCTTAACATAGGTACATCGG|GGTGTACCCAAACTCGTGGTCGACGCCGTG
ACTCGTGGTCGACGCCGTCGCATCAAGAGG|CATGGTGTACCCAAACTCGTGGTCGACGCC
GGTGTACCCAAACTCGTGGTCGACGCCGTT|ACCCTAAGGGCCTAGAGACAATGTCATACA
GGCCGGCTCTCCATATGGTGTACCCAAACT|TGTGTATGGTGTACCCAAACTCGTGGTCGA
TCCCTTTATGGGTAAACGGTCTGTTATATG|AGCAGTTTGACTATCGATTTGGTTAATAAG
CTCGTGGTCGACGCCGTCTACAGAACAAGA|TGAACATATGGTAGTTTCGCAATATTCTTC
TATATGGTGTACCCAAACTCGTGGTCGACG|AATAAGTTCACAATGACATGTTCAGAATCT
CACAGACGGTAGTTTGCCTCTATCTACTAT|GGTCTGTTATATGGTGTACCCAAACTCGTG
GTGGTCGACGCCGTAGGTCTCGGGCTTGCC|AGGTCGAGTCAACTGTTTCAGTTGTACACT
TATCGATTTGGTTAATAAGTTCACAATGAC|ACCCAAACTCGTGGTCGACGCCGTTCAACT
CGTGGTCGACGCCGTAGGTCTCGGGCTTGC|CAGGTCGAGTCAACTGTTTCAGTTGTACAC
GGCGGGAATTAGCAGTTTGACTATCGATTT|CTAGAGTTGGGTCATTGGTGTACCCAAACT
GACAACATGCCCCGCGGGTGTGCTCTAGGT|AGTTACAACAGTCTATCTCCGACCCTGGTG
GACGCCGTAATCCTGCTAGGTCTAAACGAG|GACGCCGTAGCTGGTCCCTTTATGGGTAAA
AGAAAGATACAATGGTGTACCCAAACTCGT|ACGGGGCGGACAATCTGCGGATCTTCTTCA
CTGGTCCCTTTATGGGTAAACGGTCTGTTA|AATTAGCAGTTTGACTATCGATTTGGTTAA
CGTAATCCTGCTAGGTCTAAACGAGACACA|CGTAGCTGGTCCCTTTATGGGTAAACGGTC
AGTTTGCCTCTATCTACTATCGCGAGTCGT|ATGGTGTACCCAAACTCGTGGTCGACGCCG
CAGAACAAGAGCAGCCCTAACCGGGGCTAG|AATATTCTTCTGTCCAAGGTCCCCCTAACA
TTGACTATCGATTTGGTTAATAAGTTCACA|GGTGTACCCAAACTCGTGGTCGACGCCGTT
AGGGGGACGGGGCGGACAATCTGCGGATCT|AGACGGTAGTTTGCCTCTATCTACTATCGC
CGTGGTCGACGCCGTGTACCCAAACTCGTG|ACCGTCGTATCAGGCTACGGACCCCTGTTG
CGAGACCGTCGTATCAGGCTACGGACCCCT|TGGTGTACCCAAACTCGTGGTCGACGCCGT
AATAGCTATTCTGAGCAAGGTAAGCTCTCG|AAACTCGTGGTCGACGCCGTGTACCCAAAC
CCGAAAGCTTCTCCACTGGTGTACCCAAAC|GTACGATCTGAAGTCTACTGGATATAACCA
CACGCTCGCGTCACCTAGGGTTCGGTGAAC|CAAACTCGTGGTCGACGCCGTAATCCTGCT
GTACCCAAACTCGTGGTCGACGCCGTAGCT|GTTATCTCCAACTCACCACTTGGGCGGGAA
TCGACGCCGTGGCTGAAAGGTTTGATGAGG|GAATCTCTCTACCTGGTGTACCCAAACTCG
ACGCCGTCGCATCAAGAGGACCTAGGTACG|CAAACTCGTGGTCGACGCCGTAGGTCTCGG
CGGGCTTGCCGTTTGGTGGTTGGTGTACCC|GTTGTACACTCGCTCAAAAACTCTCCATTA
TACCGAGACCGTCGTATCAGGCTACGGACC|CGTTGGTGTACCCAAACTCGTGGTCGACGC
AGCCCTAACCGGGGCTAGAGTTGGGTCATT|TCCAAGGTCCCCCTAACATACGAATCCATA
GATGAGGTAAGCGTTTCCTCCTATGAGGTT|AAACTCGTGGTCGACGCCGTCTACAGAACA
GCATCAAGAGGACCTAGGTACGGCTCTGCC|TGGTCGACGCCGTAGGTCTCGGGCTTGCCG
TCGTAAGGGGGACGGGGCGGACAATCTGCG|GACACAGACGGTAGTTTGCCTCTATCTACT
GTGTAACACCAGTTGTGTATGGTGTACCCA|CGTAGACAACATGCCCCGCGGGTGTGCTCT
GTCGTAAGGGGGACGGGGCGGACAATCTGC|AGACACAGACGGTAGTTTGCCTCTATCTAC
CTCGTGGTCGACGCCGTAATCCTGCTAGGT|CTCGTGGTCGACGCCGTAGCTGGTCCCTTT
GTTATCTCCAACTCACCACTTGGGCGGGAA|ACAAGAGCAGCCCTAACCGGGGCTAGAGTT
GTATGGTGTACCCAAACTCGTGGTCGACGC|CGCGGGTGTGCTCTAGGTTCGACACGCTCG
AAACTCGTGGTCGACGCCGTGTACCCAAAC|CCGAGACCGTCGTATCAGGCTACGGACCCC
AGAGCCCTGTCGTAAGGGGGACGGGGCGGA|TCTAAACGAGACACAGACGGTAGTTTGCCT
TGTTCAGAATCTCTCTACCTGGTGTACCCA|GACTGTTGTACGGTGTCTCCAAGACGGTCT
TTGGGCGGGAATTAGCAGTTTGACTATCGA|GGGCTAGAGTTGGGTCATTGGTGTACCCAA
TATGGTGTACCCAAACTCGTGGTCGACGCC|GCGGGTGTGCTCTAGGTTCGACACGCTCGC
GCCGGCTCTCCATATGGTGTACCCAAACTC|GTGTATGGTGTACCCAAACTCGTGGTCGAC
CAAACTCGTGGTCGACGCCGTCGCATCAAG|AACCATGGTGTACCCAAACTCGTGGTCGAC
TTGCTGGTGTACCCAAACTCGTGGTCGACG|CCTATGAGGTTATCTCCAACTCACCACTTG
CCAAACTCGTGGTCGACGCCGTAGACAACA|ATCTTCTTCAGACCTGGCAGTGAAGTTACA
CTCTGCCGTAACAAGTTGGGGTGTCGAATA|CTTGCCGTTTGGTGGTTGGTGTACCCAAAC
TGGTTAATAAGTTCACAATGACATGTTCAG|TCGTGGTCGACGCCGTTCAACTTGACTGTT
GAGCAAGGTAAGCTCTCGGGCTGTACGATC|GACGCCGTGTACCCAAACTCGTGGTCGACG
TTTGGTGGTTGGTGTACCCAAACTCGTGGT|GCTCAAAAACTCTCCATTACCGAGACCGTC
ACTTCTTAACATAGGTACATCGGGCTCACT|CCAAACTCGTGGTCGACGCCGTGTAACACC
CGACACGCTCGCGTCACCTAGGGTTCGGTG|ACCCAAACTCGTGGTCGACGCCGTAATCCT
GAATCTAGAATCATTTAATTGGATCTCAGA|TTCGGTGAACCAGAGAGCCCTGTCGTAAGG
GTAAACGGTCTGTTATATGGTGTACCCAAA|TATCGATTTGGTTAATAAGTTCACAATGAC
TAGACTTCTTAACATAGGTACATCGGGCTC|TACCCAAACTCGTGGTCGACGCCGTGTAAC
ACCATGGTGTACCCAAACTCGTGGTCGACG|TGGTCGACGCCGTACGAAGCAGGTCGAGTC
TGTACGATCTGAAGTCTACTGGATATAACC|TGGTCGACGCCGTTGTACCCAAACTCGTGG
GTTTCAGTTGTACACTCGCTCAAAAACTCT|CTCCATATGGTGTACCCAAACTCGTGGTCG
GGCTAGAGTTGGGTCATTGGTGTACCCAAA|CTAACATACGAATCCATAACCCTAAGGGCC
GGTCGACGCCGTAGGTCTCGGGCTTGCCGT|GTCGAGTCAACTGTTTCAGTTGTACACTCG
CCTAACCGGGGCTAGAGTTGGGTCATTGGT|AAGGTCCCCCTAACATACGAATCCATAACC
CCCAAACTCGTGGTCGACGCCGTCGCATCA|ATAACCATGGTGTACCCAAACTCGTGGTCG
TGTTGTGGATGGGAAGCTACTAGACTTCTT|TAGGGGCTAACTAAATGGTGTACCCAAACT
ACACGCTCGCGTCACCTAGGGTTCGGTGAA|CCAAACTCGTGGTCGACGCCGTAATCCTGC
TCTCCATATGGTGTACCCAAACTCGTGGTC|GGTGTACCCAAACTCGTGGTCGACGCCGTC
TTCGCCGCGTCGCCCTAATTGCTGGTGTAC|ATGAGGTAAGCGTTTCCTCCTATGAGGTTA
CCCGCGGGTGTGCTCTAGGTTCGACACGCT|GTCTATCTCCGACCCTGGTGTACCCAAACT
GACGCCGTCTACAGAACAAGAGCAGCCCTA|GGTAGTTTCGCAATATTCTTCTGTCCAAGG
ACGCCGTAGACAACATGCCCCGCGGGTGTG|GGCAGTGAAGTTACAACAGTCTATCTCCGA
GGTGTACCCAAACTCGTGGTCGACGCCGTG|TGGTGTACCCAAACTCGTGGTCGACGCCGT
CGGCTCTGCCGTAACAAGTTGGGGTGTCGA|GGGCTTGCCGTTTGGTGGTTGGTGTACCCA
ACGAAGCAGGTCGAGTCAACTGTTTCAGTT|CGGGCTCACTGAAGGCCGGCTCTCCATATG
TACCCAAACTCGTGGTCGACGCCGTAGACA|CGGATCTTCTTCAGACCTGGCAGTGAAGTT
TAATAAGTTCACAATGACATGTTCAGAATC|GGTCGACGCCGTTCAACTTGACTGTTGTAC
TAGGTCTAAACGAGACACAGACGGTAGTTT|CCTTTATGGGTAAACGGTCTGTTATATGGT
ACCAGTTGTGTATGGTGTACCCAAACTCGT|AACATGCCCCGCGGGTGTGCTCTAGGTTCG
GTTTCCTCCTATGAGGTTATCTCCAACTCA|GACGCCGTCTACAGAACAAGAGCAGCCCTA
GTCGACGCCGTTGGTGTACCCAAACTCGTG|GTCTGAGGTTAGAATCTAGAATCATTTAAT
ATGACATGTTCAGAATCTCTCTACCTGGTG|CAACTTGACTGTTGTACGGTGTCTCCAAGA
ATTCAGAAAGATACAATGGTGTACCCAAAC|GGGGACGGGGCGGACAATCTGCGGATCTTC
ACTCGTGGTCGACGCCGTCTGAGGTTAGAA|GGTTCGACACGCTCGCGTCACCTAGGGTTC
AGTGAAGTTACAACAGTCTATCTCCGACCC|TATGCCGATTCGCCGCGTCGCCCTAATTGC
CGCCGTGGCTGAAAGGTTTGATGAGGTAAG|CTCTCTACCTGGTGTACCCAAACTCGTGGT
GACGCCGTGTACCCAAACTCGTGGTCGACG|TATCAGGCTACGGACCCCTGTTGTGGATGG
ATTGGTGTACCCAAACTCGTGGTCGACGCC|ATAACCCTAAGGGCCTAGAGACAATGTCAT
GACGCCGTAGACAACATGCCCCGCGGGTGT|TGGCAGTGAAGTTACAACAGTCTATCTCCG
CAACATGCCCCGCGGGTGTGCTCTAGGTTC|TTACAACAGTCTATCTCCGACCCTGGTGTA
GTCGAGTCAACTGTTTCAGTTGTACACTCG|TGAAGGCCGGCTCTCCATATGGTGTACCCA
GTACCCAAACTCGTGGTCGACGCCGTTGGT|CTCGTGGTCGACGCCGTCTGAGGTTAGAAT
ACTAAATGGTGTACCCAAACTCGTGGTCGA|GATACAATGGTGTACCCAAACTCGTGGTCG
CGGACAATCTGCGGATCTTCTTCAGACCTG|GCCTCTATCTACTATCGCGAGTCGTCGCTT
CTGTTGTGGATGGGAAGCTACTAGACTTCT|GTAGGGGCTAACTAAATGGTGTACCCAAAC
TCCATTACCGAGACCGTCGTATCAGGCTAC|GACGCCGTTGGTGTACCCAAACTCGTGGTC
CGTAAGGGGGACGGGGCGGACAATCTGCGG|ACACAGACGGTAGTTTGCCTCTATCTACTA
GTTTGGTGGTTGGTGTACCCAAACTCGTGG|CGCTCAAAAACTCTCCATTACCGAGACCGT
TAACTAAATGGTGTACCCAAACTCGTGGTC|AAGATACAATGGTGTACCCAAACTCGTGGT
AGGTCTCGGGCTTGCCGTTTGGTGGTTGGT|GTTTCAGTTGTACACTCGCTCAAAAACTCT
TATGCCGATTCGCCGCGTCGCCCTAATTGC|AAGGTTTGATGAGGTAAGCGTTTCCTCCTA
CTGGATATAACCATGGTGTACCCAAACTCG|CCAAACTCGTGGTCGACGCCGTACGAAGCA
AATAAGTTCACAATGACATGTTCAGAATCT|GTCGACGCCGTTCAACTTGACTGTTGTACG
CAAGGTAAGCTCTCGGGCTGTACGATCTGA|GCCGTGTACCCAAACTCGTGGTCGACGCCG
TCGCATCAAGAGGACCTAGGTACGGCTCTG|CGTGGTCGACGCCGTAGGTCTCGGGCTTGC
TCAAAAACTCTCCATTACCGAGACCGTCGT|ACTCGTGGTCGACGCCGTTGGTGTACCCAA
ATATGGTGTACCCAAACTCGTGGTCGACGC|ACCCAAACTCGTGGTCGACGCCGTCTGAGG
